Pub order	crosswordtracker.com/clue/pub-order/
Bitter	crosswordtracker.com/clue/bitter/
Prince Valiant's wife	crosswordtracker.com/clue/prince-valiants-wife/
Bar order	crosswordtracker.com/clue/bar-order/
Brewpub order	crosswordtracker.com/clue/brewpub-order/
Brew	crosswordtracker.com/clue/brew/
Manifest	crosswordtracker.com/clue/manifest/
Tankard filler	crosswordtracker.com/clue/tankard-filler/
Draft choice	crosswordtracker.com/clue/draft-choice/
Pub serving	crosswordtracker.com/clue/pub-serving/
Pub pint	crosswordtracker.com/clue/pub-pint/
Ginger ___	crosswordtracker.com/clue/ginger-___-3/
Pub beverage	crosswordtracker.com/clue/pub-beverage/
Toby mug filler	crosswordtracker.com/clue/toby-mug-filler/
Stout	crosswordtracker.com/clue/stout-14/
Pub offering	crosswordtracker.com/clue/pub-offering/
Stein filler	crosswordtracker.com/clue/stein-filler/
Draft pick	crosswordtracker.com/clue/draft-pick/
Keg contents	crosswordtracker.com/clue/keg-contents/
Draft pick?	crosswordtracker.com/clue/draft-pick-1/
Beverage	crosswordtracker.com/clue/beverage/
Bar supply	crosswordtracker.com/clue/bar-supply/
Pub potable	crosswordtracker.com/clue/pub-potable/
Pub drink	crosswordtracker.com/clue/pub-drink-1/
Schooner filler	crosswordtracker.com/clue/schooner-filler/
Steak partner	crosswordtracker.com/clue/steak-partner/
Microbrewery output	crosswordtracker.com/clue/microbrewery-output/
Tavern order	crosswordtracker.com/clue/tavern-order/
Brewery product	crosswordtracker.com/clue/brewery-product-1/
Fermented quaff	crosswordtracker.com/clue/fermented-quaff/
Pub brew	crosswordtracker.com/clue/pub-brew/
Black and tan ingredient	crosswordtracker.com/clue/black-and-tan-ingredient/
Tylenol competitor	crosswordtracker.com/clue/tylenol-competitor/
Pub quaff	crosswordtracker.com/clue/pub-quaff/
It may be bitter	crosswordtracker.com/clue/it-may-be-bitter/
Half-and-half half	crosswordtracker.com/clue/half-and-half-half/
Porter	crosswordtracker.com/clue/porter-39/
Bass, for one	crosswordtracker.com/clue/bass-for-one/
Brewpub offering	crosswordtracker.com/clue/brewpub-offering/
Brewed beverage	crosswordtracker.com/clue/brewed-beverage/
It may be tapped	crosswordtracker.com/clue/it-may-be-tapped/
Bath suds?	crosswordtracker.com/clue/bath-suds-1/
Copper-colored cask contents	crosswordtracker.com/clue/copper-colored-cask-contents/
Pub purchase	crosswordtracker.com/clue/pub-purchase/
Potent potable	crosswordtracker.com/clue/potent-potable/
Bass, e.g.	crosswordtracker.com/clue/bass-eg/
Beer relative	crosswordtracker.com/clue/beer-relative/
Schooner contents	crosswordtracker.com/clue/schooner-contents/
Stout relative	crosswordtracker.com/clue/stout-relative/
Beer alternative	crosswordtracker.com/clue/beer-alternative/
Mug filler	crosswordtracker.com/clue/mug-filler/
Tankard contents	crosswordtracker.com/clue/tankard-contents/
Amber brew	crosswordtracker.com/clue/amber-brew/
Schooner fill	crosswordtracker.com/clue/schooner-fill/
Hearty drink	crosswordtracker.com/clue/hearty-drink/
Hearty brew	crosswordtracker.com/clue/hearty-brew/
Bass ___	crosswordtracker.com/clue/bass-___/
Sierra Nevada, e.g.	crosswordtracker.com/clue/sierra-nevada-eg/
Irish ___	crosswordtracker.com/clue/irish-___/
Bar choice	crosswordtracker.com/clue/bar-choice/
Microbrewery offering	crosswordtracker.com/clue/microbrewery-offering/
It may be pint-sized	crosswordtracker.com/clue/it-may-be-pint-sized/
Barley product	crosswordtracker.com/clue/barley-product/
British brew	crosswordtracker.com/clue/british-brew/
Ginger follower	crosswordtracker.com/clue/ginger-follower/
Cold draft	crosswordtracker.com/clue/cold-draft/
Saloon selection	crosswordtracker.com/clue/saloon-selection/
Brewed drink	crosswordtracker.com/clue/brewed-drink/
It may have a big head	crosswordtracker.com/clue/it-may-have-a-big-head/
Malt beverage	crosswordtracker.com/clue/malt-beverage-2/
It has a head and hops	crosswordtracker.com/clue/it-has-a-head-and-hops/
Hoppy brew	crosswordtracker.com/clue/hoppy-brew-1/
Barley brew	crosswordtracker.com/clue/barley-brew/
Lager alternative	crosswordtracker.com/clue/lager-alternative/
Yard filler	crosswordtracker.com/clue/yard-filler/
Word in a Maugham title	crosswordtracker.com/clue/word-in-a-maugham-title/
Pub potation	crosswordtracker.com/clue/pub-potation-1/
Steak go-with	crosswordtracker.com/clue/steak-go-with-2/
Draft drink	crosswordtracker.com/clue/draft-drink/
Lager kin	crosswordtracker.com/clue/lager-kin/
Happy hour order	crosswordtracker.com/clue/happy-hour-order/
Drink on draught	crosswordtracker.com/clue/drink-on-draught/
Rarebit ingredient	crosswordtracker.com/clue/rarebit-ingredient/
Amber, e.g.	crosswordtracker.com/clue/amber-eg/
Part of a shandy	crosswordtracker.com/clue/part-of-a-shandy/
Brewpub serving	crosswordtracker.com/clue/brewpub-serving/
Pub choice	crosswordtracker.com/clue/pub-choice/
Stein contents	crosswordtracker.com/clue/stein-contents/
Pilsner alternative	crosswordtracker.com/clue/pilsner-alternative/
Dark brew	crosswordtracker.com/clue/dark-brew/
Microbrewery product	crosswordtracker.com/clue/microbrewery-product/
Rathskeller fare	crosswordtracker.com/clue/rathskeller-fare/
Pub stock	crosswordtracker.com/clue/pub-stock-1/
Pintful, perhaps	crosswordtracker.com/clue/pintful-perhaps/
Draft choice?	crosswordtracker.com/clue/draft-choice-3/
Oktoberfest order	crosswordtracker.com/clue/oktoberfest-order-1/
Stout cousin	crosswordtracker.com/clue/stout-cousin/
Tavern serving	crosswordtracker.com/clue/tavern-serving/
Alcoholic beverage	crosswordtracker.com/clue/alcoholic-beverage-2/
Brighton brew	crosswordtracker.com/clue/brighton-brew/
Cakes' partner	crosswordtracker.com/clue/cakes-partner-1/
Welsh rabbit ingredient	crosswordtracker.com/clue/welsh-rabbit-ingredient-1/
Guinness, e.g.	crosswordtracker.com/clue/guinness-eg/
Oktoberfest drink	crosswordtracker.com/clue/oktoberfest-drink/
Bar offering	crosswordtracker.com/clue/bar-offering/
Pale potable	crosswordtracker.com/clue/pale-potable/
Quaff in a pint	crosswordtracker.com/clue/quaff-in-a-pint/
Pub suds	crosswordtracker.com/clue/pub-suds/
Ginger __	crosswordtracker.com/clue/ginger-__/
Malty mugful	crosswordtracker.com/clue/malty-mugful/
Yard sale?	crosswordtracker.com/clue/yard-sale/
Tap choice	crosswordtracker.com/clue/tap-choice/
Porter, for one	crosswordtracker.com/clue/porter-for-one/
It may be pale	crosswordtracker.com/clue/it-may-be-pale/
Brewpub staple	crosswordtracker.com/clue/brewpub-staple/
Keg filler	crosswordtracker.com/clue/keg-filler/
Heady stuff	crosswordtracker.com/clue/heady-stuff/
Bar brew	crosswordtracker.com/clue/bar-brew-1/
Hearty pub offering	crosswordtracker.com/clue/hearty-pub-offering/
Sam Adams product	crosswordtracker.com/clue/sam-adams-product/
Stout relative?	crosswordtracker.com/clue/stout-relative-3/
London libation	crosswordtracker.com/clue/london-libation/
Pub staple	crosswordtracker.com/clue/pub-staple/
Yard of ___ (pub glass)	crosswordtracker.com/clue/yard-of-___-pub-glass/
Alternative to lager	crosswordtracker.com/clue/alternative-to-lager/
Mugful	crosswordtracker.com/clue/mugful-3/
Porter, e.g.	crosswordtracker.com/clue/porter-eg/
Tavern offering	crosswordtracker.com/clue/tavern-offering-1/
Maugham's "Cakes and ___"	crosswordtracker.com/clue/maughams-cakes-and-___/
Rathskeller quaff	crosswordtracker.com/clue/rathskeller-quaff-1/
Cream ___	crosswordtracker.com/clue/cream-___/
See above	crosswordtracker.com/clue/see-above/
Guinness specialty	crosswordtracker.com/clue/guinness-specialty/
Brewer's product	crosswordtracker.com/clue/brewers-product/
Stout alternative	crosswordtracker.com/clue/stout-alternative/
Part of IPA	crosswordtracker.com/clue/part-of-ipa/
The A of IPA	crosswordtracker.com/clue/the-a-of-ipa/
Publican's pints	crosswordtracker.com/clue/publicans-pints/
Bloomsday beverage	crosswordtracker.com/clue/bloomsday-beverage/
Draught drink	crosswordtracker.com/clue/draught-drink/
Unhealthy-sounding beverage?	crosswordtracker.com/clue/unhealthy-sounding-beverage/
Falstaff's quaff	crosswordtracker.com/clue/falstaffs-quaff/
Yard contents	crosswordtracker.com/clue/yard-contents/
Pub provision	crosswordtracker.com/clue/pub-provision/
Partner of cakes	crosswordtracker.com/clue/partner-of-cakes/
Pub pour	crosswordtracker.com/clue/pub-pour/
Brewery output	crosswordtracker.com/clue/brewery-output/
Inn stock	crosswordtracker.com/clue/inn-stock/
It's drawn in pubs	crosswordtracker.com/clue/its-drawn-in-pubs/
Drink with a head on it	crosswordtracker.com/clue/drink-with-a-head-on-it/
Newcastle Brown, e.g.	crosswordtracker.com/clue/newcastle-brown-eg/
Pale brew	crosswordtracker.com/clue/pale-brew-2/
McSorley's Old ___ House	crosswordtracker.com/clue/mcsorleys-old-___-house/
Pint in a pub	crosswordtracker.com/clue/pint-in-a-pub/
The King's Head order	crosswordtracker.com/clue/the-kings-head-order/
"Cakes and ___" (Maugham novel)	crosswordtracker.com/clue/cakes-and-___-maugham-novel/
Bar beverage	crosswordtracker.com/clue/bar-beverage/
Draft option	crosswordtracker.com/clue/draft-option/
Toby filler	crosswordtracker.com/clue/toby-filler/
Welsh rabbit ingredient, often	crosswordtracker.com/clue/welsh-rabbit-ingredient-often/
Hearty pub order	crosswordtracker.com/clue/hearty-pub-order/
"Andy Capp" quaff	crosswordtracker.com/clue/andy-capp-quaff-1/
Full-bodied quaff	crosswordtracker.com/clue/full-bodied-quaff/
Bloke's brew	crosswordtracker.com/clue/blokes-brew/
Samuel Adams product	crosswordtracker.com/clue/samuel-adams-product/
"Pale" drink	crosswordtracker.com/clue/pale-drink/
Taproom order	crosswordtracker.com/clue/taproom-order/
Hearty quaff	crosswordtracker.com/clue/hearty-quaff/
Schooner's cargo	crosswordtracker.com/clue/schooners-cargo/
Ballantine, e.g.	crosswordtracker.com/clue/ballantine-eg/
Pale ___	crosswordtracker.com/clue/pale-___/
"Dark" drink	crosswordtracker.com/clue/dark-drink-1/
Pub pick	crosswordtracker.com/clue/pub-pick-1/
Draft, maybe	crosswordtracker.com/clue/draft-maybe/
Its cousin is stout	crosswordtracker.com/clue/its-cousin-is-stout/
Brewpub brew	crosswordtracker.com/clue/brewpub-brew-1/
Public house potable	crosswordtracker.com/clue/public-house-potable-1/
Half of a half-and-half	crosswordtracker.com/clue/half-of-a-half-and-half/
Steinful	crosswordtracker.com/clue/steinful/
Bitter, say	crosswordtracker.com/clue/bitter-say/
Drink in a mug	crosswordtracker.com/clue/drink-in-a-mug/
Inn drink	crosswordtracker.com/clue/inn-drink/
Hopped-up drink	crosswordtracker.com/clue/hopped-up-drink/
Hoppy drink	crosswordtracker.com/clue/hoppy-drink/
October brew	crosswordtracker.com/clue/october-brew/
Collier's cooler	crosswordtracker.com/clue/colliers-cooler/
Strong brew	crosswordtracker.com/clue/strong-brew-1/
Public house mainstay	crosswordtracker.com/clue/public-house-mainstay/
Cousin of kvass	crosswordtracker.com/clue/cousin-of-kvass/
Canadian export	crosswordtracker.com/clue/canadian-export/
Tavern quaff	crosswordtracker.com/clue/tavern-quaff-1/
Hoppy quaff	crosswordtracker.com/clue/hoppy-quaff/
Potable	crosswordtracker.com/clue/potable-4/
Maugham's "Cakes and ---"	crosswordtracker.com/clue/maughams-cakes-and--2/
Ginger adjunct	crosswordtracker.com/clue/ginger-adjunct/
Bass output	crosswordtracker.com/clue/bass-output/
Word after pale or ginger	crosswordtracker.com/clue/word-after-pale-or-ginger/
Bath suds	crosswordtracker.com/clue/bath-suds/
Tabard Inn order	crosswordtracker.com/clue/tabard-inn-order/
Pint at the pub	crosswordtracker.com/clue/pint-at-the-pub/
It may be part of a round	crosswordtracker.com/clue/it-may-be-part-of-a-round/
Top-fermented brew	crosswordtracker.com/clue/top-fermented-brew/
Tapped beverage	crosswordtracker.com/clue/tapped-beverage/
Pub draft	crosswordtracker.com/clue/pub-draft/
Inn order, perhaps	crosswordtracker.com/clue/inn-order-perhaps/
Drawn drink	crosswordtracker.com/clue/drawn-drink/
Tap output	crosswordtracker.com/clue/tap-output/
Public order?	crosswordtracker.com/clue/public-order/
Draft order	crosswordtracker.com/clue/draft-order/
Grogshop choice	crosswordtracker.com/clue/grogshop-choice/
Bar quaff	crosswordtracker.com/clue/bar-quaff/
Bass brew	crosswordtracker.com/clue/bass-brew/
Bud's heavier relative?	crosswordtracker.com/clue/buds-heavier-relative/
Tavern choice	crosswordtracker.com/clue/tavern-choice/
Inn order	crosswordtracker.com/clue/inn-order-1/
Heady order	crosswordtracker.com/clue/heady-order/
Malt drink	crosswordtracker.com/clue/malt-drink/
Merry Men's quaff	crosswordtracker.com/clue/merry-mens-quaff/
Word with house or wife	crosswordtracker.com/clue/word-with-house-or-wife/
Bass product	crosswordtracker.com/clue/bass-product/
Drink on draft	crosswordtracker.com/clue/drink-on-draft/
Drink for the inn crowd	crosswordtracker.com/clue/drink-for-the-inn-crowd/
Stout, e.g.	crosswordtracker.com/clue/stout-eg/
It's inn stock	crosswordtracker.com/clue/its-inn-stock/
Stout kin	crosswordtracker.com/clue/stout-kin/
Heady draft	crosswordtracker.com/clue/heady-draft/
Tankard brew	crosswordtracker.com/clue/tankard-brew/
McSorley's product	crosswordtracker.com/clue/mcsorleys-product/
Andy Capp's order	crosswordtracker.com/clue/andy-capps-order/
Kensington quaff	crosswordtracker.com/clue/kensington-quaff/
Malted drink	crosswordtracker.com/clue/malted-drink/
Cake partner	crosswordtracker.com/clue/cake-partner/
Adult beverage	crosswordtracker.com/clue/adult-beverage/
Brewpub glassful	crosswordtracker.com/clue/brewpub-glassful/
It might be hand-drawn	crosswordtracker.com/clue/it-might-be-hand-drawn/
It might be sold by the yard	crosswordtracker.com/clue/it-might-be-sold-by-the-yard/
Tavern drink	crosswordtracker.com/clue/tavern-drink-2/
Some schooner cargo	crosswordtracker.com/clue/some-schooner-cargo/
Rathskeller serving	crosswordtracker.com/clue/rathskeller-serving/
Ginger ___ (Canada Dry product)	crosswordtracker.com/clue/ginger-___-canada-dry-product/
Hoppy stuff	crosswordtracker.com/clue/hoppy-stuff/
Samuel Adams Summer __	crosswordtracker.com/clue/samuel-adams-summer-__/
Drink by a dartboard, often	crosswordtracker.com/clue/drink-by-a-dartboard-often/
Ballantine product	crosswordtracker.com/clue/ballantine-product/
Word that can follow pale, brown or cask	crosswordtracker.com/clue/word-that-can-follow-pale-brown-or-cask/
Stout, for one	crosswordtracker.com/clue/stout-for-one/
Schooner's contents	crosswordtracker.com/clue/schooners-contents-1/
Drink with a head	crosswordtracker.com/clue/drink-with-a-head-1/
Mugful, maybe	crosswordtracker.com/clue/mugful-maybe/
Cask contents	crosswordtracker.com/clue/cask-contents/
McSorley's offering	crosswordtracker.com/clue/mcsorleys-offering/
Public order	crosswordtracker.com/clue/public-order-1/
Public-house offering	crosswordtracker.com/clue/public-house-offering/
Drink by a dartboard	crosswordtracker.com/clue/drink-by-a-dartboard-1/
Potent pub pint	crosswordtracker.com/clue/potent-pub-pint/
Brown or pale quaff	crosswordtracker.com/clue/brown-or-pale-quaff/
Order at the Pig & Whistle	crosswordtracker.com/clue/order-at-the-pig-whistle/
Beverage for the inn crowd?	crosswordtracker.com/clue/beverage-for-the-inn-crowd/
Microbrewery pint	crosswordtracker.com/clue/microbrewery-pint/
It may be involved in a draft	crosswordtracker.com/clue/it-may-be-involved-in-a-draft/
Stout's cousin	crosswordtracker.com/clue/stouts-cousin/
Porter or stout	crosswordtracker.com/clue/porter-or-stout/
Serving on draught	crosswordtracker.com/clue/serving-on-draught/
It might be sold in a yard	crosswordtracker.com/clue/it-might-be-sold-in-a-yard/
Hearty mugful	crosswordtracker.com/clue/hearty-mugful/
It may be after ginger	crosswordtracker.com/clue/it-may-be-after-ginger/
"Ginger" follower	crosswordtracker.com/clue/ginger-follower-2/
Inn intake	crosswordtracker.com/clue/inn-intake/
Partner of steak	crosswordtracker.com/clue/partner-of-steak/
Pub draught	crosswordtracker.com/clue/pub-draught-1/
A pint, maybe	crosswordtracker.com/clue/a-pint-maybe/
Inn serving	crosswordtracker.com/clue/inn-serving/
Barrel contents	crosswordtracker.com/clue/barrel-contents/
Something brewing	crosswordtracker.com/clue/something-brewing-1/
It's intoxicating	crosswordtracker.com/clue/its-intoxicating/
Pub preference	crosswordtracker.com/clue/pub-preference/
Draft call?	crosswordtracker.com/clue/draft-call/
Hoop's outer edge	crosswordtracker.com/clue/hoops-outer-edge/
Welsh-rabbit brew	crosswordtracker.com/clue/welsh-rabbit-brew/
Libation station potation	crosswordtracker.com/clue/libation-station-potation/
Item stored in a buttery	crosswordtracker.com/clue/item-stored-in-a-buttery/
Wassail drink	crosswordtracker.com/clue/wassail-drink/
Toby contents	crosswordtracker.com/clue/toby-contents/
"Cakes and ___": Maugham	crosswordtracker.com/clue/cakes-and-___-maugham-2/
Pub item	crosswordtracker.com/clue/pub-item/
Robin Hood's quaff	crosswordtracker.com/clue/robin-hoods-quaff/
Publican's serving	crosswordtracker.com/clue/publicans-serving/
Black-and-tan ingredient	crosswordtracker.com/clue/black-and-tan-ingredient-1/
Hoppy beverage	crosswordtracker.com/clue/hoppy-beverage-1/
India pale ___	crosswordtracker.com/clue/india-pale-___/
Microbrewery brew	crosswordtracker.com/clue/microbrewery-brew/
Brewpub drink	crosswordtracker.com/clue/brewpub-drink-1/
Tavern tipple	crosswordtracker.com/clue/tavern-tipple/
Oktoberfest beverage	crosswordtracker.com/clue/oktoberfest-beverage/
Full-bodied beer	crosswordtracker.com/clue/full-bodied-beer/
Pub pintful	crosswordtracker.com/clue/pub-pintful/
It's ordered in pints	crosswordtracker.com/clue/its-ordered-in-pints/
Pub crawler's drink	crosswordtracker.com/clue/pub-crawlers-drink/
"A.M. ___" (1990s SNL ad product)	crosswordtracker.com/clue/am-___-1990s-snl-ad-product/
Alexander Keith product	crosswordtracker.com/clue/alexander-keith-product/
Calgary Stock or India Pale	crosswordtracker.com/clue/calgary-stock-or-india-pale/
Pub selection	crosswordtracker.com/clue/pub-selection-1/
Pub quencher	crosswordtracker.com/clue/pub-quencher/
Andy Capp's quaff	crosswordtracker.com/clue/andy-capps-quaff/
Brewpub output	crosswordtracker.com/clue/brewpub-output/
Fluid in a pint	crosswordtracker.com/clue/fluid-in-a-pint/
Newcastle, e.g.	crosswordtracker.com/clue/newcastle-eg/
Beverage whose homonym describes what you'll do if you drink too much of it	crosswordtracker.com/clue/beverage-whose-homonym-describes-what-youll-do-if-you-drink-too-much-of-it/
First round draft pick, perhaps	crosswordtracker.com/clue/first-round-draft-pick-perhaps/
Drink that may be made from ginger	crosswordtracker.com/clue/drink-that-may-be-made-from-ginger/
Barrel beverage	crosswordtracker.com/clue/barrel-beverage/
It's made from barley	crosswordtracker.com/clue/its-made-from-barley/
It's made with hops	crosswordtracker.com/clue/its-made-with-hops/
Brewers often flavor it with pumpkin in the fall	crosswordtracker.com/clue/brewers-often-flavor-it-with-pumpkin-in-the-fall/
It may be pale and drunk in dark rooms	crosswordtracker.com/clue/it-may-be-pale-and-drunk-in-dark-rooms/
It might be on draft	crosswordtracker.com/clue/it-might-be-on-draft/
It may be pale or brown	crosswordtracker.com/clue/it-may-be-pale-or-brown/
Samuel Adams Summer ___	crosswordtracker.com/clue/samuel-adams-summer-___/
Canterbury quaff	crosswordtracker.com/clue/canterbury-quaff/
Part of a Maugham title	crosswordtracker.com/clue/part-of-a-maugham-title/
It might be drawn	crosswordtracker.com/clue/it-might-be-drawn/
Brew in a tankard	crosswordtracker.com/clue/brew-in-a-tankard/
Capp quaff	crosswordtracker.com/clue/capp-quaff/
Cakes go-with	crosswordtracker.com/clue/cakes-go-with/
It's drawn in bars	crosswordtracker.com/clue/its-drawn-in-bars/
It might be pale or dark	crosswordtracker.com/clue/it-might-be-pale-or-dark/
Fat Tire or Bass	crosswordtracker.com/clue/fat-tire-or-bass/
Maugham's "Cakes and __"	crosswordtracker.com/clue/maughams-cakes-and-__/
Pint order	crosswordtracker.com/clue/pint-order/
Ginger or pale	crosswordtracker.com/clue/ginger-or-pale/
Pub alternative	crosswordtracker.com/clue/pub-alternative/
It may be quaffed in pints	crosswordtracker.com/clue/it-may-be-quaffed-in-pints/
Londoner's pintful	crosswordtracker.com/clue/londoners-pintful/
Ballantine brew	crosswordtracker.com/clue/ballantine-brew/
Tapped tipple	crosswordtracker.com/clue/tapped-tipple/
Malty brew	crosswordtracker.com/clue/malty-brew/
Alec's Guinness?	crosswordtracker.com/clue/alecs-guinness/
It might be pale or brown	crosswordtracker.com/clue/it-might-be-pale-or-brown/
Foamy fare	crosswordtracker.com/clue/foamy-fare/
Dark __	crosswordtracker.com/clue/dark-__/
It could be pale	crosswordtracker.com/clue/it-could-be-pale/
Oktoberfest order, perhaps	crosswordtracker.com/clue/oktoberfest-order-perhaps/
Capp's pub order	crosswordtracker.com/clue/capps-pub-order/
Maugham title drink	crosswordtracker.com/clue/maugham-title-drink/
Pete's Wicked __	crosswordtracker.com/clue/petes-wicked-__/
Darker-than-beer brew	crosswordtracker.com/clue/darker-than-beer-brew/
Bass in a glass	crosswordtracker.com/clue/bass-in-a-glass/
Word in a classic Maugham title	crosswordtracker.com/clue/word-in-a-classic-maugham-title/
It's brewed with top-fermenting yeast	crosswordtracker.com/clue/its-brewed-with-top-fermenting-yeast/
Seidel filler, sometimes	crosswordtracker.com/clue/seidel-filler-sometimes/
It may be ginger-flavored	crosswordtracker.com/clue/it-may-be-ginger-flavored/
Drink near the dartboard	crosswordtracker.com/clue/drink-near-the-dartboard/
Dark-brown brew	crosswordtracker.com/clue/dark-brown-brew/
Porter, at a bar	crosswordtracker.com/clue/porter-at-a-bar/
Steak go-with, sometimes	crosswordtracker.com/clue/steak-go-with-sometimes/
Dark drink	crosswordtracker.com/clue/dark-drink/
Drink by the dartboard	crosswordtracker.com/clue/drink-by-the-dartboard/
"Ail" homophone	crosswordtracker.com/clue/ail-homophone/
Brew in a yard	crosswordtracker.com/clue/brew-in-a-yard/
Heady quaff	crosswordtracker.com/clue/heady-quaff/
Bristol bottleful	crosswordtracker.com/clue/bristol-bottleful/
Dark or pale drink	crosswordtracker.com/clue/dark-or-pale-drink/
Pub mugful	crosswordtracker.com/clue/pub-mugful/
Brit's bitter	crosswordtracker.com/clue/brits-bitter-1/
Bass drink	crosswordtracker.com/clue/bass-drink/
Porter in a pub	crosswordtracker.com/clue/porter-in-a-pub/
Beverage with pub grub	crosswordtracker.com/clue/beverage-with-pub-grub/
Tavern pour	crosswordtracker.com/clue/tavern-pour/
Bass is one	crosswordtracker.com/clue/bass-is-one/
Bitter drink	crosswordtracker.com/clue/bitter-drink/
"Cakes and ___" (1930 Maugham novel)	crosswordtracker.com/clue/cakes-and-___-1930-maugham-novel/
It might be pale	crosswordtracker.com/clue/it-might-be-pale-2/
Source of an episode of hoppy daze?	crosswordtracker.com/clue/source-of-an-episode-of-hoppy-daze/
Something found in a schooner	crosswordtracker.com/clue/something-found-in-a-schooner/
It goes with cakes	crosswordtracker.com/clue/it-goes-with-cakes/
Brewery bottleful	crosswordtracker.com/clue/brewery-bottleful/
Brit's brew, perhaps	crosswordtracker.com/clue/brits-brew-perhaps/
''Ginger'' follower	crosswordtracker.com/clue/ginger-follower-1/
''Cakes and ___'' (Maugham novel)	crosswordtracker.com/clue/cakes-and-___-maugham-novel-1/
Part of a schooner's cargo, often	crosswordtracker.com/clue/part-of-a-schooners-cargo-often/
Cakes partner	crosswordtracker.com/clue/cakes-partner/
Beverage in a Maugham title	crosswordtracker.com/clue/beverage-in-a-maugham-title/
Public-house potable	crosswordtracker.com/clue/public-house-potable/
Stein refill, perhaps	crosswordtracker.com/clue/stein-refill-perhaps/
It may be tapped out?	crosswordtracker.com/clue/it-may-be-tapped-out-2/
''Ginger'' add-on	crosswordtracker.com/clue/ginger-add-on/
Brewery specialty, perhaps	crosswordtracker.com/clue/brewery-specialty-perhaps/
Mug filler, sometimes	crosswordtracker.com/clue/mug-filler-sometimes/
Pig and Whistle order	crosswordtracker.com/clue/pig-and-whistle-order/
It may give a bloke a buzz	crosswordtracker.com/clue/it-may-give-a-bloke-a-buzz/
Steak or cakes partner	crosswordtracker.com/clue/steak-or-cakes-partner/
Rapidly fermented quaff	crosswordtracker.com/clue/rapidly-fermented-quaff/
Friar Tuck's beverage	crosswordtracker.com/clue/friar-tucks-beverage/
Mugful at the Pig and Whistle	crosswordtracker.com/clue/mugful-at-the-pig-and-whistle/
Some pint contents	crosswordtracker.com/clue/some-pint-contents/
Andy Capp order	crosswordtracker.com/clue/andy-capp-order/
Ingredient in a black and tan	crosswordtracker.com/clue/ingredient-in-a-black-and-tan/
Inn selection	crosswordtracker.com/clue/inn-selection/
Pint drink	crosswordtracker.com/clue/pint-drink/
Bristol brew	crosswordtracker.com/clue/bristol-brew/
Happy hour order, perhaps	crosswordtracker.com/clue/happy-hour-order-perhaps/
Stein refill	crosswordtracker.com/clue/stein-refill-1/
Something on tap	crosswordtracker.com/clue/something-on-tap/
Sudsy quaff	crosswordtracker.com/clue/sudsy-quaff/
Sam Adams, maybe	crosswordtracker.com/clue/sam-adams-maybe/
Ginger ___ soda	crosswordtracker.com/clue/ginger-___-soda/
Mugful for Muggeridge	crosswordtracker.com/clue/mugful-for-muggeridge/
Andy Capp's pub order	crosswordtracker.com/clue/andy-capps-pub-order/
Beverage made from barley	crosswordtracker.com/clue/beverage-made-from-barley/
Ginger ___ (soda choice)	crosswordtracker.com/clue/ginger-___-soda-choice/
Black and tan half	crosswordtracker.com/clue/black-and-tan-half/
It may be blonde or brown	crosswordtracker.com/clue/it-may-be-blonde-or-brown/
Brew in some barrels	crosswordtracker.com/clue/brew-in-some-barrels/
Booze by the yard?	crosswordtracker.com/clue/booze-by-the-yard/
Posset ingredient	crosswordtracker.com/clue/posset-ingredient/
Quaff for Andy Capp	crosswordtracker.com/clue/quaff-for-andy-capp/
"Pale" potable	crosswordtracker.com/clue/pale-potable-1/
Microbrew, maybe	crosswordtracker.com/clue/microbrew-maybe/
Cakes' fictional partner	crosswordtracker.com/clue/cakes-fictional-partner/
McSorley's Old ___ House, New York landmark since 1854	crosswordtracker.com/clue/mcsorleys-old-___-house-new-york-landmark-since-1854/
Moose Drool or Trout Slayer	crosswordtracker.com/clue/moose-drool-or-trout-slayer/
Beerlike brew	crosswordtracker.com/clue/beerlike-brew/
Pale pub potable	crosswordtracker.com/clue/pale-pub-potable/
Wassailing choice	crosswordtracker.com/clue/wassailing-choice/
Drink from a stein	crosswordtracker.com/clue/drink-from-a-stein/
It may be red or brown	crosswordtracker.com/clue/it-may-be-red-or-brown/
Irish red, for one	crosswordtracker.com/clue/irish-red-for-one/
It may come from a barrel	crosswordtracker.com/clue/it-may-come-from-a-barrel/
It's poured in pints	crosswordtracker.com/clue/its-poured-in-pints/
Order at the Pig and Whistle	crosswordtracker.com/clue/order-at-the-pig-and-whistle/
Public offering	crosswordtracker.com/clue/public-offering/
Blonde ___	crosswordtracker.com/clue/blonde-___/
Drink often labeled XXX in the comics	crosswordtracker.com/clue/drink-often-labeled-xxx-in-the-comics/
Word with bitter or winter	crosswordtracker.com/clue/word-with-bitter-or-winter/
Stout drink	crosswordtracker.com/clue/stout-drink/
Drink in "The Taming of the Shrew"	crosswordtracker.com/clue/drink-in-the-taming-of-the-shrew/
It can fill a yard	crosswordtracker.com/clue/it-can-fill-a-yard/
Pint at a pub	crosswordtracker.com/clue/pint-at-a-pub/
Inn take	crosswordtracker.com/clue/inn-take/
Relative of beer	crosswordtracker.com/clue/relative-of-beer/
Cask serving	crosswordtracker.com/clue/cask-serving/
The tan in a Black and Tan	crosswordtracker.com/clue/the-tan-in-a-black-and-tan/
Bar option	crosswordtracker.com/clue/bar-option/
Pint contents, maybe	crosswordtracker.com/clue/pint-contents-maybe/
It may take a few hops	crosswordtracker.com/clue/it-may-take-a-few-hops/
Pint contents	crosswordtracker.com/clue/pint-contents-1/
McSorley's order	crosswordtracker.com/clue/mcsorleys-order/
Pale potation	crosswordtracker.com/clue/pale-potation/
Drink sold by the yard	crosswordtracker.com/clue/drink-sold-by-the-yard/
Sierra Nevada, for one	crosswordtracker.com/clue/sierra-nevada-for-one/
Pint poured in a pub	crosswordtracker.com/clue/pint-poured-in-a-pub/
Some six-pack contents	crosswordtracker.com/clue/some-six-pack-contents/
Word after ginger or brown	crosswordtracker.com/clue/word-after-ginger-or-brown/
Saloon order	crosswordtracker.com/clue/saloon-order/
Drink in a yard	crosswordtracker.com/clue/drink-in-a-yard/
Bottle marked "XXX" in the comics	crosswordtracker.com/clue/bottle-marked-xxx-in-the-comics/
Microbrewery buy	crosswordtracker.com/clue/microbrewery-buy/
Bar pint contents	crosswordtracker.com/clue/bar-pint-contents/
Pale or brown brew	crosswordtracker.com/clue/pale-or-brown-brew/
One might be blonde	crosswordtracker.com/clue/one-might-be-blonde/
Beerlike beverage	crosswordtracker.com/clue/beerlike-beverage-1/
"Pale" beverage	crosswordtracker.com/clue/pale-beverage/
It's sold by the pint	crosswordtracker.com/clue/its-sold-by-the-pint/
Drink sometimes indicated in comics by "XXX"	crosswordtracker.com/clue/drink-sometimes-indicated-in-comics-by-xxx/
Fat Tire product	crosswordtracker.com/clue/fat-tire-product/
Dogfish Head product	crosswordtracker.com/clue/dogfish-head-product/
Draft candidate	crosswordtracker.com/clue/draft-candidate/
Drink that may accompany fish and chips	crosswordtracker.com/clue/drink-that-may-accompany-fish-and-chips/
Oktoberfest brew	crosswordtracker.com/clue/oktoberfest-brew/
Buzzsaw Brown, e.g.	crosswordtracker.com/clue/buzzsaw-brown-eg/
It might flow in bars	crosswordtracker.com/clue/it-might-flow-in-bars/
Brewed barley beverage	crosswordtracker.com/clue/brewed-barley-beverage/
Pub fare	crosswordtracker.com/clue/pub-fare/
Porter, for example	crosswordtracker.com/clue/porter-for-example/
Tan bit of a black and tan	crosswordtracker.com/clue/tan-bit-of-a-black-and-tan/
"Ginger" drink	crosswordtracker.com/clue/ginger-drink/
Something that's not hard to drink?	crosswordtracker.com/clue/something-thats-not-hard-to-drink/
Order at the Green Dragon	crosswordtracker.com/clue/order-at-the-green-dragon/
It may be sold in yards	crosswordtracker.com/clue/it-may-be-sold-in-yards/
Many a pint	crosswordtracker.com/clue/many-a-pint/
Bar tap	crosswordtracker.com/clue/bar-tap/
Drink at the Duck and Drake	crosswordtracker.com/clue/drink-at-the-duck-and-drake/
Bitter ___	crosswordtracker.com/clue/bitter-___-1/
It might be in a yard	crosswordtracker.com/clue/it-might-be-in-a-yard/
Draft selection	crosswordtracker.com/clue/draft-selection-2/
Pilsener kin	crosswordtracker.com/clue/pilsener-kin/
Stuff sold in yards	crosswordtracker.com/clue/stuff-sold-in-yards/
Order at the Crown & Anchor	crosswordtracker.com/clue/order-at-the-crown-anchor/
Beverage that's bitterer than beer	crosswordtracker.com/clue/beverage-thats-bitterer-than-beer/
It has its head in a glass	crosswordtracker.com/clue/it-has-its-head-in-a-glass/
Nog ingredient, maybe	crosswordtracker.com/clue/nog-ingredient-maybe/
Yard contents, sometimes	crosswordtracker.com/clue/yard-contents-sometimes/
Full Sail or Fuller's	crosswordtracker.com/clue/full-sail-or-fullers/
It contains about 6% alcohol by volume	crosswordtracker.com/clue/it-contains-about-6-alcohol-by-volume/
Beverage that may be blonde or pale	crosswordtracker.com/clue/beverage-that-may-be-blonde-or-pale/
Choice in a pub	crosswordtracker.com/clue/choice-in-a-pub/
Pub standard	crosswordtracker.com/clue/pub-standard/
Nut-brown quaff	crosswordtracker.com/clue/nut-brown-quaff/
Dark-colored beer	crosswordtracker.com/clue/dark-colored-beer/
View the Notepad or read the Across clues for help.	crosswordtracker.com/clue/view-the-notepad-or-read-the-across-clues-for-help/
Bath beverage	crosswordtracker.com/clue/bath-beverage/
Cold porter	crosswordtracker.com/clue/cold-porter-2/
It may come in cases	crosswordtracker.com/clue/it-may-come-in-cases/
Bitter, to a Brit	crosswordtracker.com/clue/bitter-to-a-brit/
Pitcherful, maybe	crosswordtracker.com/clue/pitcherful-maybe/
Draught, maybe	crosswordtracker.com/clue/draught-maybe/
Old Foghorn, e.g.	crosswordtracker.com/clue/old-foghorn-eg/
XXX drink, in the comics	crosswordtracker.com/clue/xxx-drink-in-the-comics/
It has a bite and hops	crosswordtracker.com/clue/it-has-a-bite-and-hops/
Malted drink that's not a malted	crosswordtracker.com/clue/malted-drink-thats-not-a-malted/
Draft variety	crosswordtracker.com/clue/draft-variety/
Pub patron's pint	crosswordtracker.com/clue/pub-patrons-pint/
King's Head order	crosswordtracker.com/clue/kings-head-order/
The "A" in IPA	crosswordtracker.com/clue/the-a-in-ipa/
Order at the George & Dragon	crosswordtracker.com/clue/order-at-the-george-dragon/
It may be taken in in an inn	crosswordtracker.com/clue/it-may-be-taken-in-in-an-inn/
Lead-in for house or wife	crosswordtracker.com/clue/lead-in-for-house-or-wife/
It might help wash down a banger	crosswordtracker.com/clue/it-might-help-wash-down-a-banger/
Pale pub pick	crosswordtracker.com/clue/pale-pub-pick/
"Dark" quaff	crosswordtracker.com/clue/dark-quaff-1/
Old Peculier, for one	crosswordtracker.com/clue/old-peculier-for-one/
It may be inn stock	crosswordtracker.com/clue/it-may-be-inn-stock/
Publican offering	crosswordtracker.com/clue/publican-offering/
Major medieval nutrition source	crosswordtracker.com/clue/major-medieval-nutrition-source/
Oft-pale beverage	crosswordtracker.com/clue/oft-pale-beverage/
What a round might contain	crosswordtracker.com/clue/what-a-round-might-contain/
Word with "bitter" or "winter"	crosswordtracker.com/clue/word-with-bitter-or-winter-1/
Pub potion	crosswordtracker.com/clue/pub-potion/
Pilsener relative	crosswordtracker.com/clue/pilsener-relative/
Festival at Fareham	crosswordtracker.com/clue/festival-at-fareham/
Half of a Maugham pair	crosswordtracker.com/clue/half-of-a-maugham-pair/
Pothouse order	crosswordtracker.com/clue/pothouse-order/
Pub tap	crosswordtracker.com/clue/pub-tap/
Heady pub serving	crosswordtracker.com/clue/heady-pub-serving/
Bock kin	crosswordtracker.com/clue/bock-kin/
Kin of bock	crosswordtracker.com/clue/kin-of-bock/
Milwaukee product	crosswordtracker.com/clue/milwaukee-product/
"Cakes" literary partner	crosswordtracker.com/clue/cakes-literary-partner/
Rathskeller offering	crosswordtracker.com/clue/rathskeller-offering/
Malt liquor	crosswordtracker.com/clue/malt-liquor-4/
Hood's quaff	crosswordtracker.com/clue/hoods-quaff/
Wassail quaff	crosswordtracker.com/clue/wassail-quaff/
Tankard's liquid	crosswordtracker.com/clue/tankards-liquid/
Lager's relative	crosswordtracker.com/clue/lagers-relative/
Tavern brew	crosswordtracker.com/clue/tavern-brew/
Sickening drink?	crosswordtracker.com/clue/sickening-drink/
Kvass's cousin	crosswordtracker.com/clue/kvasss-cousin/
Stout stuff	crosswordtracker.com/clue/stout-stuff/
Robust drink	crosswordtracker.com/clue/robust-drink/
Tankard tipple	crosswordtracker.com/clue/tankard-tipple/
Pale or Newcastle brown	crosswordtracker.com/clue/pale-or-newcastle-brown/
Staffordshire product	crosswordtracker.com/clue/staffordshire-product/
Hearty draught	crosswordtracker.com/clue/hearty-draught/
Draft ____	crosswordtracker.com/clue/draft-____/
Porter relative	crosswordtracker.com/clue/porter-relative/
Pub pint's contents	crosswordtracker.com/clue/pub-pints-contents/
Cakes' companion	crosswordtracker.com/clue/cakes-companion/
Drink served in a Toby	crosswordtracker.com/clue/drink-served-in-a-toby/
Hot-pot ingredient	crosswordtracker.com/clue/hot-pot-ingredient/
It is often nut-brown	crosswordtracker.com/clue/it-is-often-nut-brown/
Cakes' unlikely partner	crosswordtracker.com/clue/cakes-unlikely-partner/
Sometimes it's on draft	crosswordtracker.com/clue/sometimes-its-on-draft/
Porter's cousin	crosswordtracker.com/clue/porters-cousin/
A Canadian export	crosswordtracker.com/clue/a-canadian-export/
Wassail ingredient	crosswordtracker.com/clue/wassail-ingredient-1/
"Cheers" choice	crosswordtracker.com/clue/cheers-choice/
October ___	crosswordtracker.com/clue/october-___/
Companion of cakes	crosswordtracker.com/clue/companion-of-cakes/
October beverage	crosswordtracker.com/clue/october-beverage/
Cakes and ___	crosswordtracker.com/clue/cakes-and-___-4/
Hood's refresher	crosswordtracker.com/clue/hoods-refresher/
Taproom quaff	crosswordtracker.com/clue/taproom-quaff/
Cakes' literary partner	crosswordtracker.com/clue/cakes-literary-partner-1/
October potable	crosswordtracker.com/clue/october-potable/
Pint filler	crosswordtracker.com/clue/pint-filler/
It may be represented by "XXX" in the funnies	crosswordtracker.com/clue/it-may-be-represented-by-xxx-in-the-funnies/
Porter alternative	crosswordtracker.com/clue/porter-alternative/
Ballantine ___ (bygone brand)	crosswordtracker.com/clue/ballantine-___-bygone-brand/
Ginger ___ (common mixer)	crosswordtracker.com/clue/ginger-___-common-mixer/
Fish and chips accompanier, perhaps	crosswordtracker.com/clue/fish-and-chips-accompanier-perhaps/
"Cakes and ___"	crosswordtracker.com/clue/cakes-and-___-5/
McSorley's serving	crosswordtracker.com/clue/mcsorleys-serving/
Nut-brown brew	crosswordtracker.com/clue/nut-brown-brew/
Pub crawl beverage	crosswordtracker.com/clue/pub-crawl-beverage/
Ogden Porter, e.g.	crosswordtracker.com/clue/ogden-porter-eg/
Ginger ___ (Shirley Temple ingredient)	crosswordtracker.com/clue/ginger-___-shirley-temple-ingredient/
It might be on tap	crosswordtracker.com/clue/it-might-be-on-tap/
Brewery barrelful	crosswordtracker.com/clue/brewery-barrelful/
McSorley's Old ___ House (East Village landmark)	crosswordtracker.com/clue/mcsorleys-old-___-house-east-village-landmark/
Egghot ingredient	crosswordtracker.com/clue/egghot-ingredient/
Barley wine, e.g.	crosswordtracker.com/clue/barley-wine-eg/
Contents of some kegs	crosswordtracker.com/clue/contents-of-some-kegs/
Brewery beverage	crosswordtracker.com/clue/brewery-beverage/
W. Somerset Maugham's "Cakes and ___"	crosswordtracker.com/clue/w-somerset-maughams-cakes-and-___/
Ginger ___ (soft drink)	crosswordtracker.com/clue/ginger-___-soft-drink/
Publican's pour, perhaps	crosswordtracker.com/clue/publicans-pour-perhaps/
It can be pale	crosswordtracker.com/clue/it-can-be-pale/
Pete's Wicked ___	crosswordtracker.com/clue/petes-wicked-___/
Andy Capp's drink	crosswordtracker.com/clue/andy-capps-drink/
Drink in a Maugham title	crosswordtracker.com/clue/drink-in-a-maugham-title/
It flows in bars	crosswordtracker.com/clue/it-flows-in-bars/
Sierra Nevada product	crosswordtracker.com/clue/sierra-nevada-product/
It might be tapped out	crosswordtracker.com/clue/it-might-be-tapped-out/
Newcastle Brown ___	crosswordtracker.com/clue/newcastle-brown-___/
Draft served with darts	crosswordtracker.com/clue/draft-served-with-darts/
Word on beer bottle labels	crosswordtracker.com/clue/word-on-beer-bottle-labels/
Bass from the UK, say	crosswordtracker.com/clue/bass-from-the-uk-say/
Brown ___	crosswordtracker.com/clue/brown-___-5/
Wife or house preceder	crosswordtracker.com/clue/wife-or-house-preceder/
Alexander Keith offering	crosswordtracker.com/clue/alexander-keith-offering/
India Pale is one	crosswordtracker.com/clue/india-pale-is-one/
Alexander Keith specialty	crosswordtracker.com/clue/alexander-keith-specialty/
Moosehead, for one	crosswordtracker.com/clue/moosehead-for-one/
Capilano Pale ____	crosswordtracker.com/clue/capilano-pale-____/
Calgary Stock ____	crosswordtracker.com/clue/calgary-stock-____/
Barley sandwich?	crosswordtracker.com/clue/barley-sandwich/
Word with India Pale	crosswordtracker.com/clue/word-with-india-pale/
Export or India Pale	crosswordtracker.com/clue/export-or-india-pale/
With ginger, Invention of our J.Mclaughlin	crosswordtracker.com/clue/with-ginger-invention-of-our-jmclaughlin/
India pale, for one	crosswordtracker.com/clue/india-pale-for-one/
Drink near a dartboard, maybe	crosswordtracker.com/clue/drink-near-a-dartboard-maybe/
Darker-than-beer quaff	crosswordtracker.com/clue/darker-than-beer-quaff/
It may be pint-size	crosswordtracker.com/clue/it-may-be-pint-size-1/
Foamy quaff	crosswordtracker.com/clue/foamy-quaff/
Schooner load	crosswordtracker.com/clue/schooner-load/
Quaffer's order	crosswordtracker.com/clue/quaffers-order/
It gets a head	crosswordtracker.com/clue/it-gets-a-head/
Pint for Andy Capp	crosswordtracker.com/clue/pint-for-andy-capp/
It may take some hops	crosswordtracker.com/clue/it-may-take-some-hops/
Keg quaff	crosswordtracker.com/clue/keg-quaff/
Pale drink	crosswordtracker.com/clue/pale-drink-2/
Hogshead contents, perhaps	crosswordtracker.com/clue/hogshead-contents-perhaps/
Pint glass fill	crosswordtracker.com/clue/pint-glass-fill/
It could be part of one's inn take	crosswordtracker.com/clue/it-could-be-part-of-ones-inn-take/
Tankard contents, often	crosswordtracker.com/clue/tankard-contents-often/
Schooner beverage	crosswordtracker.com/clue/schooner-beverage/
Beer's heavier cousin	crosswordtracker.com/clue/beers-heavier-cousin/
Tankard fill, perhaps	crosswordtracker.com/clue/tankard-fill-perhaps/
It's after ginger	crosswordtracker.com/clue/its-after-ginger/
Stout, for example	crosswordtracker.com/clue/stout-for-example/
Quaffer's choice	crosswordtracker.com/clue/quaffers-choice/
Ginger ---	crosswordtracker.com/clue/ginger--45/
Mersey potable	crosswordtracker.com/clue/mersey-potable/
Pint contents, perhaps	crosswordtracker.com/clue/pint-contents-perhaps/
Frothy quaff	crosswordtracker.com/clue/frothy-quaff/
Tavern product	crosswordtracker.com/clue/tavern-product/
It may come after ginger	crosswordtracker.com/clue/it-may-come-after-ginger/
Cakes companion	crosswordtracker.com/clue/cakes-companion-1/
Ginger's follower?	crosswordtracker.com/clue/gingers-follower/
Fish and chips follower, sometimes	crosswordtracker.com/clue/fish-and-chips-follower-sometimes/
"Cakes and ___" (Maugham)	crosswordtracker.com/clue/cakes-and-___-maugham-3/
Ipswich potable	crosswordtracker.com/clue/ipswich-potable/
Kin of beer	crosswordtracker.com/clue/kin-of-beer/
Schooner's cargo, perhaps	crosswordtracker.com/clue/schooners-cargo-perhaps/
Pint potable	crosswordtracker.com/clue/pint-potable/
It's more than 4 percent alcohol by volume in the U.S.	crosswordtracker.com/clue/its-more-than-4-percent-alcohol-by-volume-in-the-us/
Cake companion	crosswordtracker.com/clue/cake-companion/
Heady brew	crosswordtracker.com/clue/heady-brew-1/
Andy Capp beverage	crosswordtracker.com/clue/andy-capp-beverage/
Tavern tankardful	crosswordtracker.com/clue/tavern-tankardful/
Robin Hood quaff	crosswordtracker.com/clue/robin-hood-quaff/
Bitters, e.g.	crosswordtracker.com/clue/bitters-eg/
It may get a swelled head	crosswordtracker.com/clue/it-may-get-a-swelled-head/
Tankard fill	crosswordtracker.com/clue/tankard-fill-2/
Molson offering	crosswordtracker.com/clue/molson-offering/
Bath bubbler?	crosswordtracker.com/clue/bath-bubbler/
Barley wine, for one	crosswordtracker.com/clue/barley-wine-for-one/
Pete's Wicked, for one	crosswordtracker.com/clue/petes-wicked-for-one/
Bitter brew	crosswordtracker.com/clue/bitter-brew-1/
Trappist product	crosswordtracker.com/clue/trappist-product/
Tippler's taproom choice	crosswordtracker.com/clue/tipplers-taproom-choice/
Hearty pour	crosswordtracker.com/clue/hearty-pour/
Sam Adams Summer ___	crosswordtracker.com/clue/sam-adams-summer-___/
Choice after a long, hard day	crosswordtracker.com/clue/choice-after-a-long-hard-day/
It might be blonde or brown	crosswordtracker.com/clue/it-might-be-blonde-or-brown/
Thing drawn in bars	crosswordtracker.com/clue/thing-drawn-in-bars/
Brewhouse brew	crosswordtracker.com/clue/brewhouse-brew/
Gingery drink, at times	crosswordtracker.com/clue/gingery-drink-at-times/
IPA part	crosswordtracker.com/clue/ipa-part/
Bitter, e.g.	crosswordtracker.com/clue/bitter-eg/
Draught serving	crosswordtracker.com/clue/draught-serving/
Barley wine, really	crosswordtracker.com/clue/barley-wine-really/
"Craft" product	crosswordtracker.com/clue/craft-product/
"The stuff to drink for fellows whom it hurts to think," according to Housman	crosswordtracker.com/clue/the-stuff-to-drink-for-fellows-whom-it-hurts-to-think-according-to-housman/
Beverage of McSorley's	crosswordtracker.com/clue/beverage-of-mcsorleys/
"I would give all my fame for a pot of __": Shak.	crosswordtracker.com/clue/i-would-give-all-my-fame-for-a-pot-of-__-shak/
Tavern favorite	crosswordtracker.com/clue/tavern-favorite/
Sussex suds	crosswordtracker.com/clue/sussex-suds/
Hearty brew	http://www.crosswordgiant.com/crossword-clue/42257/Hearty-brew
Pub order	http://www.crosswordgiant.com/crossword-clue/19414/Pub-order
Brewery product	http://www.crosswordgiant.com/crossword-clue/65828/Brewery-product
Hearty quaff	http://www.crosswordgiant.com/crossword-clue/195858/Hearty-quaff
Pub pint	http://www.crosswordgiant.com/crossword-clue/17886/Pub-pint
Pub pints	http://www.crosswordgiant.com/crossword-clue/138124/Pub-pints
Pub beverage	http://www.crosswordgiant.com/crossword-clue/395600/Pub-beverage
Pub drink	http://www.crosswordgiant.com/crossword-clue/230809/Pub-drink
Ginger ___	http://www.crosswordgiant.com/crossword-clue/57227/Ginger-___
Tankard filler	http://www.crosswordgiant.com/crossword-clue/160882/Tankard-filler
Pub brew	http://www.crosswordgiant.com/crossword-clue/67966/Pub-brew
Pub offering	http://www.crosswordgiant.com/crossword-clue/122589/Pub-offering
Milwaukee product	http://www.crosswordgiant.com/crossword-clue/228461/Milwaukee-product
Saloon order	http://www.crosswordgiant.com/crossword-clue/217089/Saloon-order
Brew	http://www.crosswordgiant.com/crossword-clue/43151/Brew
Draft choice	http://www.crosswordgiant.com/crossword-clue/161223/Draft-choice
Steak partner	http://www.crosswordgiant.com/crossword-clue/210484/Steak-partner
Draft pick	http://www.crosswordgiant.com/crossword-clue/145785/Draft-pick
Beerlike beverage	http://www.crosswordgiant.com/crossword-clue/262774/Beerlike-beverage
Stein filler	http://www.crosswordgiant.com/crossword-clue/544018/Stein-filler
Pub serving	http://www.crosswordgiant.com/crossword-clue/84028/Pub-serving
Tavern quaff	http://www.crosswordgiant.com/crossword-clue/303499/Tavern-quaff
Frothy brew	http://www.crosswordgiant.com/crossword-clue/406639/Frothy-brew
Stout relative	http://www.crosswordgiant.com/crossword-clue/2778/Stout-relative
Draft pick?	http://www.crosswordgiant.com/crossword-clue/118979/Draft-pick
Pub potable	http://www.crosswordgiant.com/crossword-clue/134464/Pub-potable
Stout cousin	http://www.crosswordgiant.com/crossword-clue/233280/Stout-cousin
Brewery output	http://www.crosswordgiant.com/crossword-clue/247616/Brewery-output
Pub request	http://www.crosswordgiant.com/crossword-clue/274726/Pub-request
Hoppy brew	http://www.crosswordgiant.com/crossword-clue/282295/Hoppy-brew
Pub supply	http://www.crosswordgiant.com/crossword-clue/7650/Pub-supply
Bar order	http://www.crosswordgiant.com/crossword-clue/51701/Bar-order
Heady brew	http://www.crosswordgiant.com/crossword-clue/227344/Heady-brew
Microbrewery product	http://www.crosswordgiant.com/crossword-clue/240009/Microbrewery-product
Pub product	http://www.crosswordgiant.com/crossword-clue/296349/Pub-product
Tankard contents	http://www.crosswordgiant.com/crossword-clue/44230/Tankard-contents
Brewpub offering	http://www.crosswordgiant.com/crossword-clue/180232/Brewpub-offering
Pub quaff	http://www.crosswordgiant.com/crossword-clue/44797/Pub-quaff
Schooner filler	http://www.crosswordgiant.com/crossword-clue/147093/Schooner-filler
Bar choice	http://www.crosswordgiant.com/crossword-clue/308991/Bar-choice
Black and tan ingredient	http://www.crosswordgiant.com/crossword-clue/14972/Black-and-tan-ingredient
It may be pint-sized	http://www.crosswordgiant.com/crossword-clue/38220/It-may-be-pint-sized
British brew	http://www.crosswordgiant.com/crossword-clue/233837/British-brew
Malt beverage	http://www.crosswordgiant.com/crossword-clue/311533/Malt-beverage
Brewpub order	http://www.crosswordgiant.com/crossword-clue/322983/Brewpub-order
Brewpub product	http://www.crosswordgiant.com/crossword-clue/376959/Brewpub-product
Drink on draught	http://www.crosswordgiant.com/crossword-clue/429121/Drink-on-draught
Bath suds?	http://www.crosswordgiant.com/crossword-clue/42480/Bath-suds
Lager kin	http://www.crosswordgiant.com/crossword-clue/117303/Lager-kin
Pub potation	http://www.crosswordgiant.com/crossword-clue/237939/Pub-potation
Heady drink	http://www.crosswordgiant.com/crossword-clue/257078/Heady-drink
Drink with a head	http://www.crosswordgiant.com/crossword-clue/258552/Drink-with-a-head
Mug filler	http://www.crosswordgiant.com/crossword-clue/284109/Mug-filler
Beer cousin	http://www.crosswordgiant.com/crossword-clue/698952/Beer-cousin
Guinness specialty	http://www.crosswordgiant.com/crossword-clue/9283/Guinness-specialty
Porter	http://www.crosswordgiant.com/crossword-clue/18543/Porter
Bass, e.g.	http://www.crosswordgiant.com/crossword-clue/24578/Bass-e.g
Inn drink	http://www.crosswordgiant.com/crossword-clue/28048/Inn-drink
Tavern order	http://www.crosswordgiant.com/crossword-clue/72285/Tavern-order
Draft drink	http://www.crosswordgiant.com/crossword-clue/108399/Draft-drink
Word in a Maugham title	http://www.crosswordgiant.com/crossword-clue/118593/Word-in-a-Maugham-title
Ginger follower	http://www.crosswordgiant.com/crossword-clue/124455/Ginger-follower
Beer alternative	http://www.crosswordgiant.com/crossword-clue/127509/Beer-alternative
Stout	http://www.crosswordgiant.com/crossword-clue/134608/Stout
Schooner contents	http://www.crosswordgiant.com/crossword-clue/154751/Schooner-contents
Barley brew	http://www.crosswordgiant.com/crossword-clue/199655/Barley-brew
Beer's kin	http://www.crosswordgiant.com/crossword-clue/248325/Beers-kin
Amber brew	http://www.crosswordgiant.com/crossword-clue/254164/Amber-brew
Beer's cousin	http://www.crosswordgiant.com/crossword-clue/314523/Beers-cousin
Beer	http://www.crosswordgiant.com/crossword-clue/382458/Beer
Pub choice	http://www.crosswordgiant.com/crossword-clue/31460/Pub-choice
Bass, for one	http://www.crosswordgiant.com/crossword-clue/32566/Bass-for-one
Bass ___	http://www.crosswordgiant.com/crossword-clue/51467/Bass-___
It has a head and hops	http://www.crosswordgiant.com/crossword-clue/145587/It-has-a-head-and-hops
Pub purchase	http://www.crosswordgiant.com/crossword-clue/158954/Pub-purchase
Schooner fill	http://www.crosswordgiant.com/crossword-clue/256270/Schooner-fill
Barley product	http://www.crosswordgiant.com/crossword-clue/283218/Barley-product
Rathskeller fare	http://www.crosswordgiant.com/crossword-clue/312032/Rathskeller-fare
Brit's brew	http://www.crosswordgiant.com/crossword-clue/324394/Brits-brew
Yard filler	http://www.crosswordgiant.com/crossword-clue/490041/Yard-filler
Yard contents	http://www.crosswordgiant.com/crossword-clue/710953/Yard-contents
Pintful, perhaps	http://www.crosswordgiant.com/crossword-clue/4241/Pintful-perhaps
It may have a big head	http://www.crosswordgiant.com/crossword-clue/11072/It-may-have-a-big-head
London libation	http://www.crosswordgiant.com/crossword-clue/25969/London-libation
Welsh rabbit ingredient	http://www.crosswordgiant.com/crossword-clue/38623/Welsh-rabbit-ingredient
Dark brew	http://www.crosswordgiant.com/crossword-clue/104450/Dark-brew
Stout relative?	http://www.crosswordgiant.com/crossword-clue/138150/Stout-relative
Beer relative	http://www.crosswordgiant.com/crossword-clue/174994/Beer-relative
Stein contents	http://www.crosswordgiant.com/crossword-clue/178179/Stein-contents
Brewed beverage	http://www.crosswordgiant.com/crossword-clue/234315/Brewed-beverage
Ginger --	http://www.crosswordgiant.com/crossword-clue/273032/Ginger-
Ginger adjunct	http://www.crosswordgiant.com/crossword-clue/285638/Ginger-adjunct
Brewpub staple	http://www.crosswordgiant.com/crossword-clue/290663/Brewpub-staple
Steak go-with	http://www.crosswordgiant.com/crossword-clue/365316/Steak-go-with
Sam Adams product	http://www.crosswordgiant.com/crossword-clue/374261/Sam-Adams-product
Pilsner alternative	http://www.crosswordgiant.com/crossword-clue/453629/Pilsner-alternative
Ginger __	http://www.crosswordgiant.com/crossword-clue/540869/Ginger-__
Toby filler	http://www.crosswordgiant.com/crossword-clue/545041/Toby-filler
Microbrewery offering	http://www.crosswordgiant.com/crossword-clue/578678/Microbrewery-offering
Quaff in a pint	http://www.crosswordgiant.com/crossword-clue/587559/Quaff-in-a-pint
The A of IPA	http://www.crosswordgiant.com/crossword-clue/795419/The-A-of-IPA
Yard of ___ (pub glass)	http://www.crosswordgiant.com/crossword-clue/841495/Yard-of-___-pub-glass
Samuel Adams Summer __	http://www.crosswordgiant.com/crossword-clue/866672/Samuel-Adams-Summer-__
Rarebit ingredient	http://www.crosswordgiant.com/crossword-clue/1214263/Rarebit-ingredient
Saloon supply	http://www.crosswordgiant.com/crossword-clue/1408043/Saloon-supply
Public order	http://www.crosswordgiant.com/crossword-clue/2065/Public-order
Schooner's cargo	http://www.crosswordgiant.com/crossword-clue/18601/Schooners-cargo
Tabard Inn order	http://www.crosswordgiant.com/crossword-clue/37017/Tabard-Inn-order
Pale ___	http://www.crosswordgiant.com/crossword-clue/42431/Pale-___
It may be tapped	http://www.crosswordgiant.com/crossword-clue/59043/It-may-be-tapped
Cold draft	http://www.crosswordgiant.com/crossword-clue/72846/Cold-draft
Public house potable	http://www.crosswordgiant.com/crossword-clue/78460/Public-house-potable
Cakes' partner	http://www.crosswordgiant.com/crossword-clue/103524/Cakes-partner
Stout kin	http://www.crosswordgiant.com/crossword-clue/104217/Stout-kin
Potent potable	http://www.crosswordgiant.com/crossword-clue/114504/Potent-potable
Saloon selection	http://www.crosswordgiant.com/crossword-clue/116956/Saloon-selection
Heady stuff	http://www.crosswordgiant.com/crossword-clue/172696/Heady-stuff
Bar supply	http://www.crosswordgiant.com/crossword-clue/186068/Bar-supply
Keg contents	http://www.crosswordgiant.com/crossword-clue/187104/Keg-contents
Tap choice	http://www.crosswordgiant.com/crossword-clue/188570/Tap-choice
Pub staple	http://www.crosswordgiant.com/crossword-clue/244307/Pub-staple
Hearty drink	http://www.crosswordgiant.com/crossword-clue/253185/Hearty-drink
Pub suds	http://www.crosswordgiant.com/crossword-clue/275138/Pub-suds
Pub mugful	http://www.crosswordgiant.com/crossword-clue/277056/Pub-mugful
Newcastle Brown, e.g.	http://www.crosswordgiant.com/crossword-clue/305006/Newcastle-Brown-e.g
Cask serving	http://www.crosswordgiant.com/crossword-clue/320625/Cask-serving
Bristol beer	http://www.crosswordgiant.com/crossword-clue/322497/Bristol-beer
Cake companion	http://www.crosswordgiant.com/crossword-clue/323642/Cake-companion
Happy hour order	http://www.crosswordgiant.com/crossword-clue/355406/Happy-hour-order
Hearty pub offering	http://www.crosswordgiant.com/crossword-clue/364992/Hearty-pub-offering
Welsh rabbit ingredient, often	http://www.crosswordgiant.com/crossword-clue/391546/Welsh-rabbit-ingredient-often
Cask contents	http://www.crosswordgiant.com/crossword-clue/417234/Cask-contents
Malty mugful	http://www.crosswordgiant.com/crossword-clue/445212/Malty-mugful
It may be pale	http://www.crosswordgiant.com/crossword-clue/451529/It-may-be-pale
Bristol bottleful	http://www.crosswordgiant.com/crossword-clue/467578/Bristol-bottleful
Pale potable	http://www.crosswordgiant.com/crossword-clue/479929/Pale-potable
Full-bodied quaff	http://www.crosswordgiant.com/crossword-clue/503000/Full-bodied-quaff
Drawn drink	http://www.crosswordgiant.com/crossword-clue/503810/Drawn-drink
Pub pour	http://www.crosswordgiant.com/crossword-clue/519455/Pub-pour
Brewpub serving	http://www.crosswordgiant.com/crossword-clue/567631/Brewpub-serving
Tavern serving	http://www.crosswordgiant.com/crossword-clue/606643/Tavern-serving
Unhealthy-sounding beverage?	http://www.crosswordgiant.com/crossword-clue/608456/Unhealthy-sounding-beverage
Yard sale?	http://www.crosswordgiant.com/crossword-clue/699830/Yard-sale
Alcoholic beverage	http://www.crosswordgiant.com/crossword-clue/702353/Alcoholic-beverage
Part of IPA	http://www.crosswordgiant.com/crossword-clue/719272/Part-of-IPA
''Pale'' drink	http://www.crosswordgiant.com/crossword-clue/833873/Pale-drink
Beerlike brew	http://www.crosswordgiant.com/crossword-clue/871534/Beerlike-brew
Pub pick	http://www.crosswordgiant.com/crossword-clue/886781/Pub-pick
Guinness order	http://www.crosswordgiant.com/crossword-clue/913407/Guinness-order
Beer-like beverage	http://www.crosswordgiant.com/crossword-clue/966599/Beer-like-beverage
Serving on draught	http://www.crosswordgiant.com/crossword-clue/1235287/Serving-on-draught
Ballantine brew	http://www.crosswordgiant.com/crossword-clue/16311/Ballantine-brew
Bitter, to a Brit	http://www.crosswordgiant.com/crossword-clue/17084/Bitter-to-a-Brit
Hearty mugful	http://www.crosswordgiant.com/crossword-clue/23453/Hearty-mugful
Draft, maybe	http://www.crosswordgiant.com/crossword-clue/25596/Draft-maybe
Steinful	http://www.crosswordgiant.com/crossword-clue/25635/Steinful
It may be involved in a draft	http://www.crosswordgiant.com/crossword-clue/37726/It-may-be-involved-in-a-draft
Drink on draft	http://www.crosswordgiant.com/crossword-clue/45134/Drink-on-draft
Irish ___	http://www.crosswordgiant.com/crossword-clue/55070/Irish-___
Drink in a mug	http://www.crosswordgiant.com/crossword-clue/56157/Drink-in-a-mug
Half-and-half half	http://www.crosswordgiant.com/crossword-clue/58985/Half-and-half-half
Rathskeller quaff	http://www.crosswordgiant.com/crossword-clue/72646/Rathskeller-quaff
Kensington quaff	http://www.crosswordgiant.com/crossword-clue/73507/Kensington-quaff
Drink at the Duck and Drake	http://www.crosswordgiant.com/crossword-clue/85682/Drink-at-the-Duck-and-Drake
Brewed drink	http://www.crosswordgiant.com/crossword-clue/86197/Brewed-drink
Heady draft	http://www.crosswordgiant.com/crossword-clue/108748/Heady-draft
It may be bitter	http://www.crosswordgiant.com/crossword-clue/109286/It-may-be-bitter
Heady order	http://www.crosswordgiant.com/crossword-clue/110076/Heady-order
Harp output	http://www.crosswordgiant.com/crossword-clue/112319/Harp-output
Pub quencher	http://www.crosswordgiant.com/crossword-clue/116139/Pub-quencher
Cream ___	http://www.crosswordgiant.com/crossword-clue/117236/Cream-___
Maugham's ''Cakes and ---''	http://www.crosswordgiant.com/crossword-clue/122160/Maughams-Cakes-and-
Half of a half-and-half	http://www.crosswordgiant.com/crossword-clue/126685/Half-of-a-half-and-half
Alternative to lager	http://www.crosswordgiant.com/crossword-clue/126867/Alternative-to-lager
It may be after ginger	http://www.crosswordgiant.com/crossword-clue/127792/It-may-be-after-ginger
Public house mainstay	http://www.crosswordgiant.com/crossword-clue/172372/Public-house-mainstay
Brewpub output	http://www.crosswordgiant.com/crossword-clue/186642/Brewpub-output
Cakes companion	http://www.crosswordgiant.com/crossword-clue/186942/Cakes-companion
Oktoberfest order	http://www.crosswordgiant.com/crossword-clue/195113/Oktoberfest-order
It's intoxicating	http://www.crosswordgiant.com/crossword-clue/200112/Its-intoxicating
Brewery specialty, perhaps	http://www.crosswordgiant.com/crossword-clue/200915/Brewery-specialty-perhaps
Grogshop choice	http://www.crosswordgiant.com/crossword-clue/202259/Grogshop-choice
Inn order	http://www.crosswordgiant.com/crossword-clue/210487/Inn-order
Draft option	http://www.crosswordgiant.com/crossword-clue/213316/Draft-option
Malt drink	http://www.crosswordgiant.com/crossword-clue/214079/Malt-drink
Keg quaff	http://www.crosswordgiant.com/crossword-clue/217183/Keg-quaff
Pint in a pub	http://www.crosswordgiant.com/crossword-clue/231360/Pint-in-a-pub
Publican's pints	http://www.crosswordgiant.com/crossword-clue/241400/Publicans-pints
Publican's serving	http://www.crosswordgiant.com/crossword-clue/248382/Publicans-serving
Pub potion	http://www.crosswordgiant.com/crossword-clue/251671/Pub-potion
Darker-than-beer brew	http://www.crosswordgiant.com/crossword-clue/256623/Darker-than-beer-brew
Bass output	http://www.crosswordgiant.com/crossword-clue/258949/Bass-output
Public order?	http://www.crosswordgiant.com/crossword-clue/265566/Public-order
Andy Capp's order	http://www.crosswordgiant.com/crossword-clue/287771/Andy-Capps-order
Brit's beer	http://www.crosswordgiant.com/crossword-clue/302286/Brits-beer
Cake partner	http://www.crosswordgiant.com/crossword-clue/302868/Cake-partner
Brew-pub offering	http://www.crosswordgiant.com/crossword-clue/305489/Brew-pub-offering
Stout's cousin	http://www.crosswordgiant.com/crossword-clue/306208/Stouts-cousin
Hearty pub order	http://www.crosswordgiant.com/crossword-clue/308863/Hearty-pub-order
Bar brew	http://www.crosswordgiant.com/crossword-clue/308950/Bar-brew
Pint glass fill	http://www.crosswordgiant.com/crossword-clue/325569/Pint-glass-fill
Draft order	http://www.crosswordgiant.com/crossword-clue/337180/Draft-order
McSorley's offering	http://www.crosswordgiant.com/crossword-clue/337509/McSorleys-offering
Brighton brew	http://www.crosswordgiant.com/crossword-clue/338993/Brighton-brew
Public-house offering	http://www.crosswordgiant.com/crossword-clue/343259/Public-house-offering
It's inn stock	http://www.crosswordgiant.com/crossword-clue/351362/Its-inn-stock
Stout, e.g.	http://www.crosswordgiant.com/crossword-clue/367785/Stout-e.g
Porter, e.g.	http://www.crosswordgiant.com/crossword-clue/378790/Porter-e.g
Partner of cakes	http://www.crosswordgiant.com/crossword-clue/380053/Partner-of-cakes
Mugful	http://www.crosswordgiant.com/crossword-clue/380274/Mugful
Schooner's contents	http://www.crosswordgiant.com/crossword-clue/384787/Schooners-contents
Bar quaff	http://www.crosswordgiant.com/crossword-clue/397677/Bar-quaff
Inn order, perhaps	http://www.crosswordgiant.com/crossword-clue/399194/Inn-order-perhaps
Nut brown ___	http://www.crosswordgiant.com/crossword-clue/404153/Nut-brown-___
Adult beverage	http://www.crosswordgiant.com/crossword-clue/406599/Adult-beverage
Tankard brew	http://www.crosswordgiant.com/crossword-clue/408029/Tankard-brew
Ballantine, e.g.	http://www.crosswordgiant.com/crossword-clue/413352/Ballantine-e.g
Bitter brew	http://www.crosswordgiant.com/crossword-clue/417132/Bitter-brew
Saloon quaff	http://www.crosswordgiant.com/crossword-clue/419947/Saloon-quaff
Calgary Stock or India Pale	http://www.crosswordgiant.com/crossword-clue/421418/Calgary-Stock-or-India-Pale
Drink with a head on it	http://www.crosswordgiant.com/crossword-clue/423457/Drink-with-a-head-on-it
Draft choice?	http://www.crosswordgiant.com/crossword-clue/446851/Draft-choice
Pub draft	http://www.crosswordgiant.com/crossword-clue/468036/Pub-draft
Pub provision	http://www.crosswordgiant.com/crossword-clue/487222/Pub-provision
Stein drink	http://www.crosswordgiant.com/crossword-clue/487974/Stein-drink
Fermented beverage	http://www.crosswordgiant.com/crossword-clue/518320/Fermented-beverage
Malt liquor	http://www.crosswordgiant.com/crossword-clue/518454/Malt-liquor
Lager alternative	http://www.crosswordgiant.com/crossword-clue/518702/Lager-alternative
Bloomsday beverage	http://www.crosswordgiant.com/crossword-clue/524083/Bloomsday-beverage
Stout alternative	http://www.crosswordgiant.com/crossword-clue/532014/Stout-alternative
Toby drink	http://www.crosswordgiant.com/crossword-clue/532464/Toby-drink
Bath suds	http://www.crosswordgiant.com/crossword-clue/551757/Bath-suds
Brewpub glassful	http://www.crosswordgiant.com/crossword-clue/559980/Brewpub-glassful
Inn stock	http://www.crosswordgiant.com/crossword-clue/566851/Inn-stock
Mugful, maybe	http://www.crosswordgiant.com/crossword-clue/578537/Mugful-maybe
Potent brew	http://www.crosswordgiant.com/crossword-clue/582054/Potent-brew
Stein refill, perhaps	http://www.crosswordgiant.com/crossword-clue/588621/Stein-refill-perhaps
Pub stuff	http://www.crosswordgiant.com/crossword-clue/600447/Pub-stuff
Full-bodied beer	http://www.crosswordgiant.com/crossword-clue/620256/Full-bodied-beer
Tankard refill	http://www.crosswordgiant.com/crossword-clue/628967/Tankard-refill
Pint at the pub	http://www.crosswordgiant.com/crossword-clue/633938/Pint-at-the-pub
Pub pintful	http://www.crosswordgiant.com/crossword-clue/645547/Pub-pintful
It may be part of a round	http://www.crosswordgiant.com/crossword-clue/652402/It-may-be-part-of-a-round
Heady quaff	http://www.crosswordgiant.com/crossword-clue/655603/Heady-quaff
Top-fermented brew	http://www.crosswordgiant.com/crossword-clue/666159/Top-fermented-brew
Its cousin is stout	http://www.crosswordgiant.com/crossword-clue/670228/Its-cousin-is-stout
Ginger ___ (Canada Dry product)	http://www.crosswordgiant.com/crossword-clue/695125/Ginger-___-Canada-Dry-product
Microbrew, maybe	http://www.crosswordgiant.com/crossword-clue/735757/Microbrew-maybe
Bristol brew	http://www.crosswordgiant.com/crossword-clue/743775/Bristol-brew
Brewpub quaff	http://www.crosswordgiant.com/crossword-clue/767351/Brewpub-quaff
Bud's heavier relative?	http://www.crosswordgiant.com/crossword-clue/772847/Buds-heavier-relative
"Andy Capp" quaff	http://www.crosswordgiant.com/crossword-clue/773052/Andy-Capp-quaff
Hoppy drink	http://www.crosswordgiant.com/crossword-clue/801934/Hoppy-drink
Hoppy quaff	http://www.crosswordgiant.com/crossword-clue/822590/Hoppy-quaff
Pub standard	http://www.crosswordgiant.com/crossword-clue/836941/Pub-standard
Word that can follow pale, brown or cask	http://www.crosswordgiant.com/crossword-clue/854412/Word-that-can-follow-pale-brown-or-cask
IPA part	http://www.crosswordgiant.com/crossword-clue/860717/IPA-part
Drink by a dartboard	http://www.crosswordgiant.com/crossword-clue/884958/Drink-by-a-dartboard
Potent pub pint	http://www.crosswordgiant.com/crossword-clue/895840/Potent-pub-pint
Maugham's "Cakes and ___"	http://www.crosswordgiant.com/crossword-clue/897742/Maughams-Cakes-and-___
Brown or pale quaff	http://www.crosswordgiant.com/crossword-clue/902060/Brown-or-pale-quaff
Flagon filler	http://www.crosswordgiant.com/crossword-clue/914740/Flagon-filler
Beverage for the inn crowd?	http://www.crosswordgiant.com/crossword-clue/919593/Beverage-for-the-inn-crowd
Alexander Keith product	http://www.crosswordgiant.com/crossword-clue/933587/Alexander-Keith-product
The bier sounds as if it might make one sick	http://www.crosswordgiant.com/crossword-clue/1176083/The-bier-sounds-as-if-it-might-make-one-sick
Part of 42-Across	http://www.crosswordgiant.com/crossword-clue/1395230/Part-of-42-Across
"Ginger" follower	http://www.crosswordgiant.com/crossword-clue/1410713/Ginger-follower
Brewpub brew	http://www.crosswordgiant.com/crossword-clue/1414887/Brewpub-brew
McSorley's Old ___ House	http://www.crosswordgiant.com/crossword-clue/1458584/McSorleys-Old-___-House
Bitter, e.g	http://www.crosswordgiant.com/crossword-clue/1462810/Bitter-e.g
India Pale ___	http://www.crosswordgiant.com/crossword-clue/1480719/India-Pale-___
Beverage of McSorley's	http://www.crosswordgiant.com/crossword-clue/1486157/Beverage-of-McSorleys
''I would give all my fame for a pot of __'': Shak	http://www.crosswordgiant.com/crossword-clue/1486851/I-would-give-all-my-fame-for-a-pot-of-__-Shak
Bexley beer	http://www.crosswordgiant.com/crossword-clue/1486960/Bexley-beer
Tavern favorite	http://www.crosswordgiant.com/crossword-clue/1487618/Tavern-favorite
Sussex suds	http://www.crosswordgiant.com/crossword-clue/1488692/Sussex-suds
11-Down cousin	http://www.crosswordgiant.com/crossword-clue/1491040/11-Down-cousin
Brew in a pint	http://www.crosswordgiant.com/crossword-clue/1491857/Brew-in-a-pint
Tylenol competitor	http://www.crosswordgiant.com/crossword-clue/1818/Tylenol-competitor
Cold porter	http://www.crosswordgiant.com/crossword-clue/6208/Cold-porter
It may come in cases	http://www.crosswordgiant.com/crossword-clue/6638/It-may-come-in-cases
Bar offering	http://www.crosswordgiant.com/crossword-clue/15281/Bar-offering
See 44-Across	http://www.crosswordgiant.com/crossword-clue/15377/See-44-Across
Pitcherful, maybe	http://www.crosswordgiant.com/crossword-clue/17815/Pitcherful-maybe
Draught, maybe	http://www.crosswordgiant.com/crossword-clue/18866/Draught-maybe
Old Foghorn, e.g.	http://www.crosswordgiant.com/crossword-clue/22611/Old-Foghorn-e.g
Bubbly beverage	http://www.crosswordgiant.com/crossword-clue/30496/Bubbly-beverage
XXX drink, in the comics	http://www.crosswordgiant.com/crossword-clue/33057/XXX-drink-in-the-comics
It has a bite and hops	http://www.crosswordgiant.com/crossword-clue/35780/It-has-a-bite-and-hops
Manifest	http://www.crosswordgiant.com/crossword-clue/46802/Manifest
Pub stock	http://www.crosswordgiant.com/crossword-clue/54356/Pub-stock
Malted drink that's not a malted	http://www.crosswordgiant.com/crossword-clue/56763/Malted-drink-thats-not-a-malted
Draft call?	http://www.crosswordgiant.com/crossword-clue/62343/Draft-call
King's Head order	http://www.crosswordgiant.com/crossword-clue/62774/Kings-Head-order
It might be hand-drawn	http://www.crosswordgiant.com/crossword-clue/63685/It-might-be-hand-drawn
Order at the George & Dragon	http://www.crosswordgiant.com/crossword-clue/66120/Order-at-the-George-Dragon
It may be taken in in an inn	http://www.crosswordgiant.com/crossword-clue/68618/It-may-be-taken-in-in-an-inn
Tavern offering	http://www.crosswordgiant.com/crossword-clue/68786/Tavern-offering
Lead-in for house or wife	http://www.crosswordgiant.com/crossword-clue/69025/Lead-in-for-house-or-wife
A pint, maybe	http://www.crosswordgiant.com/crossword-clue/70659/A-pint-maybe
Order at the Pig & Whistle	http://www.crosswordgiant.com/crossword-clue/72224/Order-at-the-Pig-Whistle
It might help wash down a banger	http://www.crosswordgiant.com/crossword-clue/72588/It-might-help-wash-down-a-banger
Bitter ___	http://www.crosswordgiant.com/crossword-clue/101884/Bitter-___
Ginger ---	http://www.crosswordgiant.com/crossword-clue/111923/Ginger-
Mersey potable	http://www.crosswordgiant.com/crossword-clue/112017/Mersey-potable
Pint contents, perhaps	http://www.crosswordgiant.com/crossword-clue/115022/Pint-contents-perhaps
Barrel contents	http://www.crosswordgiant.com/crossword-clue/121658/Barrel-contents
Frothy quaff	http://www.crosswordgiant.com/crossword-clue/121829/Frothy-quaff
Tavern product	http://www.crosswordgiant.com/crossword-clue/126301/Tavern-product
It might be in a yard	http://www.crosswordgiant.com/crossword-clue/131558/It-might-be-in-a-yard
Bitters, e.g.	http://www.crosswordgiant.com/crossword-clue/132305/Bitters-e.g
It may get a swelled head	http://www.crosswordgiant.com/crossword-clue/136866/It-may-get-a-swelled-head
Draft selection	http://www.crosswordgiant.com/crossword-clue/137126/Draft-selection
Pilsener kin	http://www.crosswordgiant.com/crossword-clue/141903/Pilsener-kin
Stuff sold in yards	http://www.crosswordgiant.com/crossword-clue/143669/Stuff-sold-in-yards
Strong brew	http://www.crosswordgiant.com/crossword-clue/153087/Strong-brew
Order at the Crown & Anchor	http://www.crosswordgiant.com/crossword-clue/162363/Order-at-the-Crown-Anchor
Tankard fill	http://www.crosswordgiant.com/crossword-clue/164566/Tankard-fill
It may come after ginger	http://www.crosswordgiant.com/crossword-clue/170568/It-may-come-after-ginger
Oktoberfest quaff	http://www.crosswordgiant.com/crossword-clue/172792/Oktoberfest-quaff
Amber, e.g.	http://www.crosswordgiant.com/crossword-clue/176158/Amber-e.g
Maugham's 'Cakes and ___'	http://www.crosswordgiant.com/crossword-clue/177210/Maughams-Cakes-and-___
Andy Capp's quaff	http://www.crosswordgiant.com/crossword-clue/177954/Andy-Capps-quaff
Beverage that's bitterer than beer	http://www.crosswordgiant.com/crossword-clue/190406/Beverage-thats-bitterer-than-beer
It has its head in a glass	http://www.crosswordgiant.com/crossword-clue/193695/It-has-its-head-in-a-glass
Maugham's "Cakes and ---"	http://www.crosswordgiant.com/crossword-clue/193794/Maughams-Cakes-and-
Something brewing	http://www.crosswordgiant.com/crossword-clue/193842/Something-brewing
It may be pint-size	http://www.crosswordgiant.com/crossword-clue/194420/It-may-be-pint-size
Partner of steak	http://www.crosswordgiant.com/crossword-clue/198216/Partner-of-steak
Bitter, say	http://www.crosswordgiant.com/crossword-clue/198341/Bitter-say
Ginger's follower?	http://www.crosswordgiant.com/crossword-clue/199513/Gingers-follower
Foamy quaff	http://www.crosswordgiant.com/crossword-clue/202095/Foamy-quaff
Fish and chips follower, sometimes	http://www.crosswordgiant.com/crossword-clue/203222/Fish-and-chips-follower-sometimes
Bath beverage	http://www.crosswordgiant.com/crossword-clue/203389/Bath-beverage
Schooner load	http://www.crosswordgiant.com/crossword-clue/203935/Schooner-load
Quaffer's order	http://www.crosswordgiant.com/crossword-clue/209358/Quaffers-order
It gets a head	http://www.crosswordgiant.com/crossword-clue/211046/It-gets-a-head
Pint for Andy Capp	http://www.crosswordgiant.com/crossword-clue/212475/Pint-for-Andy-Capp
It may take some hops	http://www.crosswordgiant.com/crossword-clue/213056/It-may-take-some-hops
Molson offering	http://www.crosswordgiant.com/crossword-clue/220597/Molson-offering
Mug contents, maybe	http://www.crosswordgiant.com/crossword-clue/227385/Mug-contents-maybe
Brewery creation	http://www.crosswordgiant.com/crossword-clue/232357/Brewery-creation
Happy-hour order	http://www.crosswordgiant.com/crossword-clue/234139/Happy-hour-order
Nog ingredient, maybe	http://www.crosswordgiant.com/crossword-clue/235270/Nog-ingredient-maybe
"Cakes and ___" (Maugham)	http://www.crosswordgiant.com/crossword-clue/237268/Cakes-and-___-Maugham
Ipswich potable	http://www.crosswordgiant.com/crossword-clue/237775/Ipswich-potable
Kin of beer	http://www.crosswordgiant.com/crossword-clue/243889/Kin-of-beer
Schooner's cargo, perhaps	http://www.crosswordgiant.com/crossword-clue/246603/Schooners-cargo-perhaps
Pub  order	http://www.crosswordgiant.com/crossword-clue/252223/Pub-order
Kin of 53-Across	http://www.crosswordgiant.com/crossword-clue/254982/Kin-of-53-Across
Schooner cargo, often	http://www.crosswordgiant.com/crossword-clue/256789/Schooner-cargo-often
It contains about 6% alcohol by volume	http://www.crosswordgiant.com/crossword-clue/263558/It-contains-about-6-alcohol-by-volume
Falstaff's quencher	http://www.crosswordgiant.com/crossword-clue/264451/Falstaffs-quencher
Milwau-kee product	http://www.crosswordgiant.com/crossword-clue/265406/Milwau-kee-product
Drink  with a head	http://www.crosswordgiant.com/crossword-clue/269258/Drink-with-a-head
Libation station potation	http://www.crosswordgiant.com/crossword-clue/270908/Libation-station-potation
Sierra Nevada, e.g.	http://www.crosswordgiant.com/crossword-clue/274408/Sierra-Nevada-e.g
Pub  supply	http://www.crosswordgiant.com/crossword-clue/278376/Pub-supply
Pale drink	http://www.crosswordgiant.com/crossword-clue/279815/Pale-drink
RenFest beverage	http://www.crosswordgiant.com/crossword-clue/281226/RenFest-beverage
Hogshead contents, perhaps	http://www.crosswordgiant.com/crossword-clue/289309/Hogshead-contents-perhaps
Pint potable	http://www.crosswordgiant.com/crossword-clue/292275/Pint-potable
Publican's product	http://www.crosswordgiant.com/crossword-clue/296879/Publicans-product
Pint at a pub	http://www.crosswordgiant.com/crossword-clue/299134/Pint-at-a-pub
Tavern request	http://www.crosswordgiant.com/crossword-clue/303147/Tavern-request
It's more than 4 percent alcohol by volume in the U.S.	http://www.crosswordgiant.com/crossword-clue/306365/Its-more-than-4-percent-alcohol-by-volume-in-the-U.S
Inn take	http://www.crosswordgiant.com/crossword-clue/308654/Inn-take
Relative of beer	http://www.crosswordgiant.com/crossword-clue/309754/Relative-of-beer
Bath bubbler?	http://www.crosswordgiant.com/crossword-clue/310403/Bath-bubbler
Bitter beer	http://www.crosswordgiant.com/crossword-clue/311515/Bitter-beer
It could be part of one's inn take	http://www.crosswordgiant.com/crossword-clue/327459/It-could-be-part-of-ones-inn-take
Tankard contents, often	http://www.crosswordgiant.com/crossword-clue/328660/Tankard-contents-often
Barley wine, for one	http://www.crosswordgiant.com/crossword-clue/340603/Barley-wine-for-one
'Cakes and ___' (Maugham novel)	http://www.crosswordgiant.com/crossword-clue/341323/Cakes-and-___-Maugham-novel
Brown drink	http://www.crosswordgiant.com/crossword-clue/344143/Brown-drink
Bass product	http://www.crosswordgiant.com/crossword-clue/351628/Bass-product
Andy Capp beverage	http://www.crosswordgiant.com/crossword-clue/353257/Andy-Capp-beverage
It may be drawn	http://www.crosswordgiant.com/crossword-clue/357419/It-may-be-drawn
Kin of 22-Down	http://www.crosswordgiant.com/crossword-clue/367557/Kin-of-22-Down
Beer for a Brit	http://www.crosswordgiant.com/crossword-clue/367788/Beer-for-a-Brit
Seidel filler, sometimes	http://www.crosswordgiant.com/crossword-clue/369171/Seidel-filler-sometimes
Boddington's Pub ___	http://www.crosswordgiant.com/crossword-clue/377403/Boddingtons-Pub-___
It may be ginger-flavored	http://www.crosswordgiant.com/crossword-clue/378507/It-may-be-ginger-flavored
Public offering	http://www.crosswordgiant.com/crossword-clue/386834/Public-offering
Drink near the dartboard	http://www.crosswordgiant.com/crossword-clue/388123/Drink-near-the-dartboard
Capilano Pale ____	http://www.crosswordgiant.com/crossword-clue/390073/Capilano-Pale-____
Beverage	http://www.crosswordgiant.com/crossword-clue/392050/Beverage
Draught pick	http://www.crosswordgiant.com/crossword-clue/403699/Draught-pick
Dark-brown brew	http://www.crosswordgiant.com/crossword-clue/404807/Dark-brown-brew
Quaffer's choice	http://www.crosswordgiant.com/crossword-clue/408481/Quaffers-choice
Brit's brew, perhaps	http://www.crosswordgiant.com/crossword-clue/410274/Brits-brew-perhaps
Micro-brewery product	http://www.crosswordgiant.com/crossword-clue/410873/Micro-brewery-product
Porter, at a bar	http://www.crosswordgiant.com/crossword-clue/413854/Porter-at-a-bar
Bar tab item	http://www.crosswordgiant.com/crossword-clue/416653/Bar-tab-item
Potable	http://www.crosswordgiant.com/crossword-clue/421432/Potable
Steak go-with, sometimes	http://www.crosswordgiant.com/crossword-clue/422410/Steak-go-with-sometimes
Dark drink	http://www.crosswordgiant.com/crossword-clue/424616/Dark-drink
Brown ___	http://www.crosswordgiant.com/crossword-clue/435046/Brown-___
Drink by the dartboard	http://www.crosswordgiant.com/crossword-clue/438567/Drink-by-the-dartboard
Blonde ___	http://www.crosswordgiant.com/crossword-clue/441876/Blonde-___
Beer kin	http://www.crosswordgiant.com/crossword-clue/442783/Beer-kin
Bass brew	http://www.crosswordgiant.com/crossword-clue/446874/Bass-brew
68 Across order	http://www.crosswordgiant.com/crossword-clue/449746/68-Across-order
Porter, for one	http://www.crosswordgiant.com/crossword-clue/449785/Porter-for-one
Drink often labeled XXX in the comics	http://www.crosswordgiant.com/crossword-clue/450248/Drink-often-labeled-XXX-in-the-comics
Home brew product	http://www.crosswordgiant.com/crossword-clue/450790/Home-brew-product
Stout brew	http://www.crosswordgiant.com/crossword-clue/452888/Stout-brew
It's drawn in pubs	http://www.crosswordgiant.com/crossword-clue/458807/Its-drawn-in-pubs
'Pale' drink	http://www.crosswordgiant.com/crossword-clue/461501/Pale-drink
Bath suds?	http://www.crosswordgiant.com/crossword-clue/469650/Bath-suds
Type of beer	http://www.crosswordgiant.com/crossword-clue/471610/Type-of-beer
It may have a big head when drawn	http://www.crosswordgiant.com/crossword-clue/473959/It-may-have-a-big-head-when-drawn
''Ginger'' follower	http://www.crosswordgiant.com/crossword-clue/476401/Ginger-follower
Dark __	http://www.crosswordgiant.com/crossword-clue/479144/Dark-__
It could be pale	http://www.crosswordgiant.com/crossword-clue/489255/It-could-be-pale
Brit's bitter	http://www.crosswordgiant.com/crossword-clue/490042/Brits-bitter
Word with bitter or winter	http://www.crosswordgiant.com/crossword-clue/490131/Word-with-bitter-or-winter
Fluid in a pint	http://www.crosswordgiant.com/crossword-clue/497804/Fluid-in-a-pint
Oktoberfest order, perhaps	http://www.crosswordgiant.com/crossword-clue/503857/Oktoberfest-order-perhaps
Tap output	http://www.crosswordgiant.com/crossword-clue/506196/Tap-output
Stout drink	http://www.crosswordgiant.com/crossword-clue/514950/Stout-drink
Malty brew	http://www.crosswordgiant.com/crossword-clue/515003/Malty-brew
''Cakes and ___'' (Maugham novel)	http://www.crosswordgiant.com/crossword-clue/515172/Cakes-and-___-Maugham-novel
Microbrewery output	http://www.crosswordgiant.com/crossword-clue/519728/Microbrewery-output
Part of a schooner's cargo, often	http://www.crosswordgiant.com/crossword-clue/520232/Part-of-a-schooners-cargo-often
Pub buy	http://www.crosswordgiant.com/crossword-clue/522635/Pub-buy
Pub  offering	http://www.crosswordgiant.com/crossword-clue/525083/Pub-offering
Capp's pub order	http://www.crosswordgiant.com/crossword-clue/526161/Capps-pub-order
Drink in 'The Taming of the Shrew'	http://www.crosswordgiant.com/crossword-clue/537428/Drink-in-The-Taming-of-the-Shrew
...and brew ordered there	http://www.crosswordgiant.com/crossword-clue/541565/...and-brew-ordered-there
Maugham title drink	http://www.crosswordgiant.com/crossword-clue/541636/Maugham-title-drink
Pete's Wicked __	http://www.crosswordgiant.com/crossword-clue/542106/Petes-Wicked-__
Bass in a glass	http://www.crosswordgiant.com/crossword-clue/545572/Bass-in-a-glass
Brighton beer	http://www.crosswordgiant.com/crossword-clue/546167/Brighton-beer
Word in a classic Maugham title	http://www.crosswordgiant.com/crossword-clue/547751/Word-in-a-classic-Maugham-title
It's brewed with top-fermenting yeast	http://www.crosswordgiant.com/crossword-clue/557435/Its-brewed-with-top-fermenting-yeast
Cakes partner	http://www.crosswordgiant.com/crossword-clue/558152/Cakes-partner
Foam-topped beverage	http://www.crosswordgiant.com/crossword-clue/558158/Foam-topped-beverage
Stein quaff	http://www.crosswordgiant.com/crossword-clue/561156/Stein-quaff
1-Down is one	http://www.crosswordgiant.com/crossword-clue/562099/1-Down-is-one
It can fill a yard	http://www.crosswordgiant.com/crossword-clue/566564/It-can-fill-a-yard
Beer hall buy	http://www.crosswordgiant.com/crossword-clue/566752/Beer-hall-buy
Hearty draught	http://www.crosswordgiant.com/crossword-clue/570282/Hearty-draught
Drink with cakes	http://www.crosswordgiant.com/crossword-clue/574464/Drink-with-cakes
Beverage in a Maugham title	http://www.crosswordgiant.com/crossword-clue/574693/Beverage-in-a-Maugham-title
Public-house potable	http://www.crosswordgiant.com/crossword-clue/576134/Public-house-potable
Nappy beverage	http://www.crosswordgiant.com/crossword-clue/577647/Nappy-beverage
Andy Capp's drink	http://www.crosswordgiant.com/crossword-clue/577836/Andy-Capps-drink
India pale --	http://www.crosswordgiant.com/crossword-clue/579087/India-pale-
Inn draft	http://www.crosswordgiant.com/crossword-clue/583647/Inn-draft
Newcastle, e.g.	http://www.crosswordgiant.com/crossword-clue/586711/Newcastle-e.g
Part of a Maugham title	http://www.crosswordgiant.com/crossword-clue/588613/Part-of-a-Maugham-title
It might be drawn	http://www.crosswordgiant.com/crossword-clue/591055/It-might-be-drawn
Brew in a tankard	http://www.crosswordgiant.com/crossword-clue/595942/Brew-in-a-tankard
Capp quaff	http://www.crosswordgiant.com/crossword-clue/596179/Capp-quaff
Cakes go-with	http://www.crosswordgiant.com/crossword-clue/598226/Cakes-go-with
McSorley's product	http://www.crosswordgiant.com/crossword-clue/599251/McSorleys-product
Hearty pour	http://www.crosswordgiant.com/crossword-clue/604682/Hearty-pour
It's drawn in bars	http://www.crosswordgiant.com/crossword-clue/607114/Its-drawn-in-bars
Hoppy stuff	http://www.crosswordgiant.com/crossword-clue/609265/Hoppy-stuff
It might be pale or dark	http://www.crosswordgiant.com/crossword-clue/619574/It-might-be-pale-or-dark
Fat Tire or Bass	http://www.crosswordgiant.com/crossword-clue/620004/Fat-Tire-or-Bass
It may be tapped out?	http://www.crosswordgiant.com/crossword-clue/620533/It-may-be-tapped-out
Maugham's "Cakes and __"	http://www.crosswordgiant.com/crossword-clue/622702/Maughams-Cakes-and-__
British beer	http://www.crosswordgiant.com/crossword-clue/623398/British-beer
''Ginger'' add-on	http://www.crosswordgiant.com/crossword-clue/626963/Ginger-add-on
Irish red, for one	http://www.crosswordgiant.com/crossword-clue/628197/Irish-red-for-one
Falstaff's quaff	http://www.crosswordgiant.com/crossword-clue/628730/Falstaffs-quaff
It may come from a barrel	http://www.crosswordgiant.com/crossword-clue/629269/It-may-come-from-a-barrel
Pint order	http://www.crosswordgiant.com/crossword-clue/629698/Pint-order
The King's Head order	http://www.crosswordgiant.com/crossword-clue/630448/The-Kings-Head-order
Dart thrower's order	http://www.crosswordgiant.com/crossword-clue/633248/Dart-throwers-order
Beverage whose homonym describes what you'll do if you drink too much of it	http://www.crosswordgiant.com/crossword-clue/634619/Beverage-whose-homonym-describes-what-youll-do-if-you-drink-too-much-of-it
Calgary Stock ____	http://www.crosswordgiant.com/crossword-clue/639500/Calgary-Stock-____
Samuel Adams product	http://www.crosswordgiant.com/crossword-clue/639550/Samuel-Adams-product
Ginger or pale	http://www.crosswordgiant.com/crossword-clue/644319/Ginger-or-pale
It may be quaffed in pints	http://www.crosswordgiant.com/crossword-clue/646302/It-may-be-quaffed-in-pints
Pub alternative	http://www.crosswordgiant.com/crossword-clue/646314/Pub-alternative
It may be on tap in taprooms	http://www.crosswordgiant.com/crossword-clue/648785/It-may-be-on-tap-in-taprooms
It's poured in pints	http://www.crosswordgiant.com/crossword-clue/649299/Its-poured-in-pints
Barley sandwich?	http://www.crosswordgiant.com/crossword-clue/651155/Barley-sandwich
1-Across request	http://www.crosswordgiant.com/crossword-clue/652035/1-Across-request
Londoner's pintful	http://www.crosswordgiant.com/crossword-clue/659205/Londoners-pintful
Mug filler, sometimes	http://www.crosswordgiant.com/crossword-clue/661955/Mug-filler-sometimes
Order at the Pig and Whistle	http://www.crosswordgiant.com/crossword-clue/662440/Order-at-the-Pig-and-Whistle
Pete's Wicked, for one	http://www.crosswordgiant.com/crossword-clue/667135/Petes-Wicked-for-one
Toby brew	http://www.crosswordgiant.com/crossword-clue/677690/Toby-brew
Contents of some kegs	http://www.crosswordgiant.com/crossword-clue/679632/Contents-of-some-kegs
Tapped tipple	http://www.crosswordgiant.com/crossword-clue/680936/Tapped-tipple
Malted drink	http://www.crosswordgiant.com/crossword-clue/683318/Malted-drink
It's ordered in pints	http://www.crosswordgiant.com/crossword-clue/684405/Its-ordered-in-pints
It's ordered in pints	http://www.crosswordgiant.com/crossword-clue/685812/Its-ordered-in-pints
Beer in Bath	http://www.crosswordgiant.com/crossword-clue/688949/Beer-in-Bath
Wassailing choice	http://www.crosswordgiant.com/crossword-clue/692268/Wassailing-choice
Mersey mugful	http://www.crosswordgiant.com/crossword-clue/692754/Mersey-mugful
Stout cousin?	http://www.crosswordgiant.com/crossword-clue/693181/Stout-cousin
Pub crawler's drink	http://www.crosswordgiant.com/crossword-clue/695342/Pub-crawlers-drink
Pub crawler's drink	http://www.crosswordgiant.com/crossword-clue/695786/Pub-crawlers-drink
Pig and Whistle order	http://www.crosswordgiant.com/crossword-clue/695833/Pig-and-Whistle-order
Word with India Pale	http://www.crosswordgiant.com/crossword-clue/698903/Word-with-India-Pale
It may give a bloke a buzz	http://www.crosswordgiant.com/crossword-clue/700098/It-may-give-a-bloke-a-buzz
Tapped beverage	http://www.crosswordgiant.com/crossword-clue/701314/Tapped-beverage
First-round draft pick?	http://www.crosswordgiant.com/crossword-clue/702323/First-round-draft-pick
Steak or cakes partner	http://www.crosswordgiant.com/crossword-clue/705373/Steak-or-cakes-partner
Rapidly fermented quaff	http://www.crosswordgiant.com/crossword-clue/705647/Rapidly-fermented-quaff
Alec's Guinness?	http://www.crosswordgiant.com/crossword-clue/716843/Alecs-Guinness
Dark or pale drink	http://www.crosswordgiant.com/crossword-clue/718398/Dark-or-pale-drink
Drink from a stein	http://www.crosswordgiant.com/crossword-clue/720976/Drink-from-a-stein
Friar Tuck's beverage	http://www.crosswordgiant.com/crossword-clue/729127/Friar-Tucks-beverage
"Cakes and ___" (Maugham novel)	http://www.crosswordgiant.com/crossword-clue/729887/Cakes-and-___-Maugham-novel
Sam Adams Summer ___	http://www.crosswordgiant.com/crossword-clue/734935/Sam-Adams-Summer-___
Mugful at the Pig and Whistle	http://www.crosswordgiant.com/crossword-clue/735180/Mugful-at-the-Pig-and-Whistle
It may be red or brown	http://www.crosswordgiant.com/crossword-clue/745045/It-may-be-red-or-brown
Some pint contents	http://www.crosswordgiant.com/crossword-clue/745992/Some-pint-contents
First round draft pick, perhaps	http://www.crosswordgiant.com/crossword-clue/755190/First-round-draft-pick-perhaps
It might be pale or brown	http://www.crosswordgiant.com/crossword-clue/756790/It-might-be-pale-or-brown
Andy Capp order	http://www.crosswordgiant.com/crossword-clue/766003/Andy-Capp-order
Foamy fare	http://www.crosswordgiant.com/crossword-clue/766933/Foamy-fare
It's poured in pints	http://www.crosswordgiant.com/crossword-clue/767343/Its-poured-in-pints
Rathskeller serving	http://www.crosswordgiant.com/crossword-clue/773215/Rathskeller-serving
"Ail" homophone	http://www.crosswordgiant.com/crossword-clue/774172/Ail-homophone
Tavern choice	http://www.crosswordgiant.com/crossword-clue/774187/Tavern-choice
Brew in a yard	http://www.crosswordgiant.com/crossword-clue/783536/Brew-in-a-yard
'A.M. ___' (1990s SNL ad product)	http://www.crosswordgiant.com/crossword-clue/783969/A.M.-___-1990s-SNL-ad-product
McSorley's Old ___ House, New York landmark since 1854	http://www.crosswordgiant.com/crossword-clue/784713/McSorleys-Old-___-House-New-York-landmark-since-1854
"A.M. ___" (1990s SNL ad product)	http://www.crosswordgiant.com/crossword-clue/785344/A.M.-___-1990s-SNL-ad-product
Ballantine product	http://www.crosswordgiant.com/crossword-clue/791203/Ballantine-product
First round draft pick?	http://www.crosswordgiant.com/crossword-clue/792405/First-round-draft-pick
Ingredient in a black and tan	http://www.crosswordgiant.com/crossword-clue/795615/Ingredient-in-a-black-and-tan
Inn selection	http://www.crosswordgiant.com/crossword-clue/798071/Inn-selection
Cousin of 7-Across	http://www.crosswordgiant.com/crossword-clue/802358/Cousin-of-7-Across
Pint drink	http://www.crosswordgiant.com/crossword-clue/802636/Pint-drink
It might be sold by the yard	http://www.crosswordgiant.com/crossword-clue/802779/It-might-be-sold-by-the-yard
Tavern drink	http://www.crosswordgiant.com/crossword-clue/809067/Tavern-drink
Drink that may be made from ginger	http://www.crosswordgiant.com/crossword-clue/810961/Drink-that-may-be-made-from-ginger
Something to fill a 28 Down	http://www.crosswordgiant.com/crossword-clue/813088/Something-to-fill-a-28-Down
Some schooner cargo	http://www.crosswordgiant.com/crossword-clue/815037/Some-schooner-cargo
It may be after "ginger"	http://www.crosswordgiant.com/crossword-clue/817074/It-may-be-after-ginger
Drafted stuff	http://www.crosswordgiant.com/crossword-clue/817302/Drafted-stuff
It's drawn in pubs	http://www.crosswordgiant.com/crossword-clue/818990/Its-drawn-in-pubs
Happy hour order, perhaps	http://www.crosswordgiant.com/crossword-clue/821806/Happy-hour-order-perhaps
Stein refill	http://www.crosswordgiant.com/crossword-clue/823627/Stein-refill
Sam Adams, maybe	http://www.crosswordgiant.com/crossword-clue/828055/Sam-Adams-maybe
Export or India Pale	http://www.crosswordgiant.com/crossword-clue/829279/Export-or-India-Pale
With ginger, Invention of our J.Mclaughlin	http://www.crosswordgiant.com/crossword-clue/831221/With-ginger-Invention-of-our-J.Mclaughlin
Ginger ___ soda	http://www.crosswordgiant.com/crossword-clue/831428/Ginger-___-soda
Mugful for Muggeridge	http://www.crosswordgiant.com/crossword-clue/832760/Mugful-for-Muggeridge
Beverage made from barley	http://www.crosswordgiant.com/crossword-clue/834299/Beverage-made-from-barley
Choice after a long, hard day	http://www.crosswordgiant.com/crossword-clue/835771/Choice-after-a-long-hard-day
Cakes' partner	http://www.crosswordgiant.com/crossword-clue/839243/Cakes-partner
Ginger ___ (soda choice)	http://www.crosswordgiant.com/crossword-clue/839990/Ginger-___-soda-choice
Black and tan half	http://www.crosswordgiant.com/crossword-clue/842473/Black-and-tan-half
It may be blonde or brown	http://www.crosswordgiant.com/crossword-clue/843736/It-may-be-blonde-or-brown
Brew pub offering	http://www.crosswordgiant.com/crossword-clue/845758/Brew-pub-offering
Booze by the yard?	http://www.crosswordgiant.com/crossword-clue/847242/Booze-by-the-yard
Quaff for Andy Capp	http://www.crosswordgiant.com/crossword-clue/851023/Quaff-for-Andy-Capp
''Pale'' potable	http://www.crosswordgiant.com/crossword-clue/853707/Pale-potable
11-Across staple	http://www.crosswordgiant.com/crossword-clue/854969/11-Across-staple
India pale, for one	http://www.crosswordgiant.com/crossword-clue/858031/India-pale-for-one
Word after pale or ginger	http://www.crosswordgiant.com/crossword-clue/860977/Word-after-pale-or-ginger
Moose Drool or Trout Slayer	http://www.crosswordgiant.com/crossword-clue/861222/Moose-Drool-or-Trout-Slayer
Cakes' fictional partner	http://www.crosswordgiant.com/crossword-clue/863201/Cakes-fictional-partner
Pale brew	http://www.crosswordgiant.com/crossword-clue/864522/Pale-brew
Stout, for one	http://www.crosswordgiant.com/crossword-clue/865340/Stout-for-one
Drink by a dartboard, often	http://www.crosswordgiant.com/crossword-clue/867978/Drink-by-a-dartboard-often
Merry Men's quaff	http://www.crosswordgiant.com/crossword-clue/870931/Merry-Mens-quaff
Pale pub potable	http://www.crosswordgiant.com/crossword-clue/875617/Pale-pub-potable
Bloke's brew	http://www.crosswordgiant.com/crossword-clue/876604/Blokes-brew
Saloon brew	http://www.crosswordgiant.com/crossword-clue/877203/Saloon-brew
Barrel beverage	http://www.crosswordgiant.com/crossword-clue/878019/Barrel-beverage
Black and tan beverage	http://www.crosswordgiant.com/crossword-clue/879065/Black-and-tan-beverage
''Dark'' drink	http://www.crosswordgiant.com/crossword-clue/882319/Dark-drink
The tan in a Black and Tan	http://www.crosswordgiant.com/crossword-clue/883459/The-tan-in-a-Black-and-Tan
Bar option	http://www.crosswordgiant.com/crossword-clue/883623/Bar-option
Hoppy beverage	http://www.crosswordgiant.com/crossword-clue/887762/Hoppy-beverage
Beer, in Bath	http://www.crosswordgiant.com/crossword-clue/891990/Beer-in-Bath
Ballantine ___ (bygone brand)	http://www.crosswordgiant.com/crossword-clue/893311/Ballantine-___-bygone-brand
Pint contents, maybe	http://www.crosswordgiant.com/crossword-clue/896341/Pint-contents-maybe
It may take a few hops	http://www.crosswordgiant.com/crossword-clue/897195/It-may-take-a-few-hops
Pint contents	http://www.crosswordgiant.com/crossword-clue/898392/Pint-contents
McSorley's order	http://www.crosswordgiant.com/crossword-clue/898597/McSorleys-order
Pale potation	http://www.crosswordgiant.com/crossword-clue/899036/Pale-potation
Trappist product	http://www.crosswordgiant.com/crossword-clue/899050/Trappist-product
Drink sold by the yard	http://www.crosswordgiant.com/crossword-clue/902524/Drink-sold-by-the-yard
Sierra Nevada, for one	http://www.crosswordgiant.com/crossword-clue/909942/Sierra-Nevada-for-one
Pint poured in a pub	http://www.crosswordgiant.com/crossword-clue/911091/Pint-poured-in-a-pub
Order at the Pig & Whistle	http://www.crosswordgiant.com/crossword-clue/911939/Order-at-the-Pig-Whistle
It might be blonde or brown	http://www.crosswordgiant.com/crossword-clue/913305/It-might-be-blonde-or-brown
Word on beer bottle labels	http://www.crosswordgiant.com/crossword-clue/914942/Word-on-beer-bottle-labels
Tavern tankardful	http://www.crosswordgiant.com/crossword-clue/916946/Tavern-tankardful
Nut brown beverage	http://www.crosswordgiant.com/crossword-clue/918449/Nut-brown-beverage
Some six-pack contents	http://www.crosswordgiant.com/crossword-clue/920371/Some-six-pack-contents
Alexander Keith specialty	http://www.crosswordgiant.com/crossword-clue/922679/Alexander-Keith-specialty
Word after ginger or brown	http://www.crosswordgiant.com/crossword-clue/922687/Word-after-ginger-or-brown
Thing drawn in bars	http://www.crosswordgiant.com/crossword-clue/926895/Thing-drawn-in-bars
Drink in a yard	http://www.crosswordgiant.com/crossword-clue/927279/Drink-in-a-yard
Microbrewery pint	http://www.crosswordgiant.com/crossword-clue/929479/Microbrewery-pint
Bottle marked 'XXX' in the comics	http://www.crosswordgiant.com/crossword-clue/930797/Bottle-marked-XXX-in-the-comics
It's made from barley	http://www.crosswordgiant.com/crossword-clue/932840/Its-made-from-barley
It's made with hops	http://www.crosswordgiant.com/crossword-clue/936320/Its-made-with-hops
English beer, may be bitter	http://www.crosswordgiant.com/crossword-clue/952607/English-beer-may-be-bitter
Beer consumed in chalets	http://www.crosswordgiant.com/crossword-clue/953220/Beer-consumed-in-chalets
Beer consumed in sales	http://www.crosswordgiant.com/crossword-clue/958815/Beer-consumed-in-sales
English beer	http://www.crosswordgiant.com/crossword-clue/970334/English-beer
Similar to beer	http://www.crosswordgiant.com/crossword-clue/985671/Similar-to-beer
Beer procured in sales	http://www.crosswordgiant.com/crossword-clue/990232/Beer-procured-in-sales
English beer, mild or bitter	http://www.crosswordgiant.com/crossword-clue/1015825/English-beer-mild-or-bitter
English beer in sales	http://www.crosswordgiant.com/crossword-clue/1028242/English-beer-in-sales
Does he brew this?	http://www.crosswordgiant.com/crossword-clue/1043589/Does-he-brew-this
Have one of the 8 down withyour drink like this for a hoop	http://www.crosswordgiant.com/crossword-clue/1052966/Have-one-of-the-8-down-withyour-drink-like-this-for-a-hoop
Some beer for George Russell when he's about fifty	http://www.crosswordgiant.com/crossword-clue/1059512/Some-beer-for-George-Russell-when-hes-about-fifty
Drink to the start of 30 across	http://www.crosswordgiant.com/crossword-clue/1060119/Drink-to-the-start-of-30-across
See 1 down	http://www.crosswordgiant.com/crossword-clue/1066359/See-1-down
2 down might get back to drink like this for a start	http://www.crosswordgiant.com/crossword-clue/1067870/2-down-might-get-back-to-drink-like-this-for-a-start
Around fifty, Russell is not 9 across	http://www.crosswordgiant.com/crossword-clue/1069283/Around-fifty-Russell-is-not-9-across
A farthing more of this would have made the dress outstanding	http://www.crosswordgiant.com/crossword-clue/1070021/A-farthing-more-of-this-would-have-made-the-dress-outstanding
Is drink needed to keep the unaspirated hearty?	http://www.crosswordgiant.com/crossword-clue/1071293/Is-drink-needed-to-keep-the-unaspirated-hearty
The sort of drink an S.C. might play with	http://www.crosswordgiant.com/crossword-clue/1074180/The-sort-of-drink-an-S.C.-might-play-with
After 1 down, from the outskirts came very cheap beer	http://www.crosswordgiant.com/crossword-clue/1089296/After-1-down-from-the-outskirts-came-very-cheap-beer
That may get one pickled and 'earty	http://www.crosswordgiant.com/crossword-clue/1090853/That-may-get-one-pickled-and-earty
Sounds as if one might get sick of drink like this	http://www.crosswordgiant.com/crossword-clue/1101190/Sounds-as-if-one-might-get-sick-of-drink-like-this
Drink the outside of 13 across	http://www.crosswordgiant.com/crossword-clue/1111387/Drink-the-outside-of-13-across
Just a drink with 15 across after five	http://www.crosswordgiant.com/crossword-clue/1112767/Just-a-drink-with-15-across-after-five
Just a pint with the French	http://www.crosswordgiant.com/crossword-clue/1117681/Just-a-pint-with-the-French
Reg was able to fill himself up with this	http://www.crosswordgiant.com/crossword-clue/1123014/Reg-was-able-to-fill-himself-up-with-this
Drink sounds as if it might make one sick	http://www.crosswordgiant.com/crossword-clue/1124681/Drink-sounds-as-if-it-might-make-one-sick
Not to be found in 10 across, but one may ration it within reason	http://www.crosswordgiant.com/crossword-clue/1127280/Not-to-be-found-in-10-across-but-one-may-ration-it-within-reason
The pastor would have this rustic sort of a drink	http://www.crosswordgiant.com/crossword-clue/1140454/The-pastor-would-have-this-rustic-sort-of-a-drink
The same sort of thing as 18 down, but clearer	http://www.crosswordgiant.com/crossword-clue/1142627/The-same-sort-of-thing-as-18-down-but-clearer
B e'er a the in France?	http://www.crosswordgiant.com/crossword-clue/1146266/B-eer-a-the-in-France
Hebrews this?	http://www.crosswordgiant.com/crossword-clue/1150291/Hebrews-this
A drink with the French in England	http://www.crosswordgiant.com/crossword-clue/1152723/A-drink-with-the-French-in-England
Barley wine, for example	http://www.crosswordgiant.com/crossword-clue/1195012/Barley-wine-for-example
Microbrewery buy	http://www.crosswordgiant.com/crossword-clue/1202186/Microbrewery-buy
Brewers often flavor it with pumpkin in the fall	http://www.crosswordgiant.com/crossword-clue/1208488/Brewers-often-flavor-it-with-pumpkin-in-the-fall
Bar pint contents	http://www.crosswordgiant.com/crossword-clue/1209497/Bar-pint-contents
Pale or brown brew	http://www.crosswordgiant.com/crossword-clue/1215770/Pale-or-brown-brew
One might be blonde	http://www.crosswordgiant.com/crossword-clue/1218484/One-might-be-blonde
Bitter beverage	http://www.crosswordgiant.com/crossword-clue/1218697/Bitter-beverage
Brewhouse brew	http://www.crosswordgiant.com/crossword-clue/1225328/Brewhouse-brew
Porter or stout	http://www.crosswordgiant.com/crossword-clue/1228697/Porter-or-stout
''Pale'' beverage	http://www.crosswordgiant.com/crossword-clue/1228918/Pale-beverage
It's sold by the pint	http://www.crosswordgiant.com/crossword-clue/1229363/Its-sold-by-the-pint
Wife or house preceder	http://www.crosswordgiant.com/crossword-clue/1235674/Wife-or-house-preceder
Fat Tire product	http://www.crosswordgiant.com/crossword-clue/1237651/Fat-Tire-product
It may be pale and drunk in dark rooms	http://www.crosswordgiant.com/crossword-clue/1238546/It-may-be-pale-and-drunk-in-dark-rooms
Dogfish Head product	http://www.crosswordgiant.com/crossword-clue/1243917/Dogfish-Head-product
It might be sold in a yard	http://www.crosswordgiant.com/crossword-clue/1249631/It-might-be-sold-in-a-yard
Draft candidate	http://www.crosswordgiant.com/crossword-clue/1250232/Draft-candidate
Drink that may accompany fish and chips	http://www.crosswordgiant.com/crossword-clue/1251355/Drink-that-may-accompany-fish-and-chips
It might be on draft	http://www.crosswordgiant.com/crossword-clue/1251923/It-might-be-on-draft
Oktoberfest brew	http://www.crosswordgiant.com/crossword-clue/1251932/Oktoberfest-brew
Buzzsaw Brown, e.g	http://www.crosswordgiant.com/crossword-clue/1404232/Buzzsaw-Brown-e.g
1-Across kin	http://www.crosswordgiant.com/crossword-clue/1411496/1-Across-kin
It may be pale or brown	http://www.crosswordgiant.com/crossword-clue/1413828/It-may-be-pale-or-brown
Pub fare	http://www.crosswordgiant.com/crossword-clue/1420268/Pub-fare
Porter, for example	http://www.crosswordgiant.com/crossword-clue/1421427/Porter-for-example
Sierra Nevada, e.g	http://www.crosswordgiant.com/crossword-clue/1421807/Sierra-Nevada-e.g
"Ginger" drink	http://www.crosswordgiant.com/crossword-clue/1421885/Ginger-drink
Something that's not hard to drink?	http://www.crosswordgiant.com/crossword-clue/1425011/Something-thats-not-hard-to-drink
Gingery drink, at times	http://www.crosswordgiant.com/crossword-clue/1426648/Gingery-drink-at-times
Publican's pour, perhaps	http://www.crosswordgiant.com/crossword-clue/1427510/Publicans-pour-perhaps
Yard contents, sometimes	http://www.crosswordgiant.com/crossword-clue/1428792/Yard-contents-sometimes
Kin of 37-Across	http://www.crosswordgiant.com/crossword-clue/1430336/Kin-of-37-Across
Full Sail or Fuller's	http://www.crosswordgiant.com/crossword-clue/1431351/Full-Sail-or-Fullers
Samuel Adams Summer ___	http://www.crosswordgiant.com/crossword-clue/1433046/Samuel-Adams-Summer-___
Choice in a pub	http://www.crosswordgiant.com/crossword-clue/1434318/Choice-in-a-pub
Alexander Keith offering	http://www.crosswordgiant.com/crossword-clue/1437220/Alexander-Keith-offering
India Pale is one	http://www.crosswordgiant.com/crossword-clue/1440592/India-Pale-is-one
The 'A' in IPA	http://www.crosswordgiant.com/crossword-clue/1444738/The-A-in-IPA
London brew	http://www.crosswordgiant.com/crossword-clue/1449732/London-brew
'Dark' quaff	http://www.crosswordgiant.com/crossword-clue/1457994/Dark-quaff
It may be inn stock	http://www.crosswordgiant.com/crossword-clue/1458559/It-may-be-inn-stock
13 Down serving	http://www.crosswordgiant.com/crossword-clue/1463050/13-Down-serving
Pub beer	http://www.crosswordgiant.com/crossword-clue/1463115/Pub-beer
Oft-pale beverage	http://www.crosswordgiant.com/crossword-clue/1467559/Oft-pale-beverage
What a round might contain	http://www.crosswordgiant.com/crossword-clue/1468365/What-a-round-might-contain
Word with "bitter" or "winter"	http://www.crosswordgiant.com/crossword-clue/1469800/Word-with-bitter-or-winter
Pilsener relative	http://www.crosswordgiant.com/crossword-clue/1473201/Pilsener-relative
Hoop's outer edge	http://www.crosswordgiant.com/crossword-clue/1474400/Hoops-outer-edge
Pint filler	http://www.crosswordgiant.com/crossword-clue/1474825/Pint-filler
Drink with plenty of 10-Across	http://www.crosswordgiant.com/crossword-clue/1475534/Drink-with-plenty-of-10-Across
It may be represented by 'XXX' in the funnies	http://www.crosswordgiant.com/crossword-clue/1477841/It-may-be-represented-by-XXX-in-the-funnies
Draught serving	http://www.crosswordgiant.com/crossword-clue/1480667/Draught-serving
Canterbury quaff	http://www.crosswordgiant.com/crossword-clue/1481521/Canterbury-quaff
Taproom order	http://www.crosswordgiant.com/crossword-clue/1481844/Taproom-order
Barley wine, really	http://www.crosswordgiant.com/crossword-clue/1482283/Barley-wine-really
''Craft'' product	http://www.crosswordgiant.com/crossword-clue/1483160/Craft-product
It has a head and hops?	http://www.crosswordgiant.com/crossword-clue/1493692/It-has-a-head-and-hops
Word with "house" or "bitter"	http://www.crosswordgiant.com/crossword-clue/1495146/Word-with-house-or-bitter
Newcastle specialty	http://www.crosswordgiant.com/crossword-clue/1495881/Newcastle-specialty
Rathskeller specialty	http://www.crosswordgiant.com/crossword-clue/1497570/Rathskeller-specialty
Tankard drink	http://www.crosswordgiant.com/crossword-clue/1500614/Tankard-drink
Tavern brew	http://www.crosswordgiant.com/crossword-clue/1501012/Tavern-brew
Beverage with fish and chips, perhaps	http://www.crosswordgiant.com/crossword-clue/1501453/Beverage-with-fish-and-chips-perhaps
Summer ___	http://www.crosswordgiant.com/crossword-clue/1502114/Summer-___
Light-coloured beer	http://www.crosswordgiant.com/crossword-clue/1502264/Light-coloured-beer
It may be blond or pale	http://www.crosswordgiant.com/crossword-clue/1502511/It-may-be-blond-or-pale
