Cauliflower ___	crosswordtracker.com/clue/cauliflower-___/
Notice	crosswordtracker.com/clue/notice/
Corn serving	crosswordtracker.com/clue/corn-serving/
Corn unit	crosswordtracker.com/clue/corn-unit/
Attention	crosswordtracker.com/clue/attention/
Bud holder?	crosswordtracker.com/clue/bud-holder-3/
Talent for music	crosswordtracker.com/clue/talent-for-music/
Listening device	crosswordtracker.com/clue/listening-device/
Canal site	crosswordtracker.com/clue/canal-site/
Heed	crosswordtracker.com/clue/heed/
Place for a stud	crosswordtracker.com/clue/place-for-a-stud/
Canal zone?	crosswordtracker.com/clue/canal-zone-2/
Stud site	crosswordtracker.com/clue/stud-site/
Elephant's floppy feature	crosswordtracker.com/clue/elephants-floppy-feature/
Ring site	crosswordtracker.com/clue/ring-site/
Audition	crosswordtracker.com/clue/audition/
Musician's asset	crosswordtracker.com/clue/musicians-asset/
Place for a ring	crosswordtracker.com/clue/place-for-a-ring/
Place for a plug	crosswordtracker.com/clue/place-for-a-plug/
Receptor	crosswordtracker.com/clue/receptor-1/
Musical talent	crosswordtracker.com/clue/musical-talent/
Ring bearer	crosswordtracker.com/clue/ring-bearer/
It may be plugged or pierced	crosswordtracker.com/clue/it-may-be-plugged-or-pierced/
Pitcher part	crosswordtracker.com/clue/pitcher-part/
Hearing aid?	crosswordtracker.com/clue/hearing-aid/
Word with phone or ring	crosswordtracker.com/clue/word-with-phone-or-ring/
Musical gift	crosswordtracker.com/clue/musical-gift/
Musical aptitude	crosswordtracker.com/clue/musical-aptitude/
Musical ability	crosswordtracker.com/clue/musical-ability/
Corn portion	crosswordtracker.com/clue/corn-portion/
Dog-___	crosswordtracker.com/clue/dog-___/
Mr. Potato Head piece	crosswordtracker.com/clue/mr-potato-head-piece/
Bud holder	crosswordtracker.com/clue/bud-holder/
Body part	crosswordtracker.com/clue/body-part-20/
Jug handle	crosswordtracker.com/clue/jug-handle/
Canal locale	crosswordtracker.com/clue/canal-locale/
Spike	crosswordtracker.com/clue/spike/
Sound receiver	crosswordtracker.com/clue/sound-receiver/
Pinna	crosswordtracker.com/clue/pinna-6/
Musical sense	crosswordtracker.com/clue/musical-sense/
Acoustic organ	crosswordtracker.com/clue/acoustic-organ/
Ring bearer?	crosswordtracker.com/clue/ring-bearer-2/
Field unit	crosswordtracker.com/clue/field-unit/
It may be cocked	crosswordtracker.com/clue/it-may-be-cocked/
Lobe locale	crosswordtracker.com/clue/lobe-locale/
It may be pulled	crosswordtracker.com/clue/it-may-be-pulled/
Organ with a drum	crosswordtracker.com/clue/organ-with-a-drum/
Singer's asset	crosswordtracker.com/clue/singers-asset/
Listener	crosswordtracker.com/clue/listener/
Drum site	crosswordtracker.com/clue/drum-site-1/
Auricle	crosswordtracker.com/clue/auricle-1/
Corn container	crosswordtracker.com/clue/corn-container/
Audio receiver	crosswordtracker.com/clue/audio-receiver/
Bit of corn	crosswordtracker.com/clue/bit-of-corn/
Order of corn	crosswordtracker.com/clue/order-of-corn/
Otologist's concern	crosswordtracker.com/clue/otologists-concern/
Sympathetic attention	crosswordtracker.com/clue/sympathetic-attention/
Shucker's unit	crosswordtracker.com/clue/shuckers-unit/
Bean sprout?	crosswordtracker.com/clue/bean-sprout-1/
Pitch catcher	crosswordtracker.com/clue/pitch-catcher/
Ring setting	crosswordtracker.com/clue/ring-setting-1/
Piercing site	crosswordtracker.com/clue/piercing-site-1/
Audience	crosswordtracker.com/clue/audience-7/
Wax producer	crosswordtracker.com/clue/wax-producer-1/
Portion of corn	crosswordtracker.com/clue/portion-of-corn/
Knack for music	crosswordtracker.com/clue/knack-for-music/
Something to lend or bend	crosswordtracker.com/clue/something-to-lend-or-bend/
Van Gogh had one later in life	crosswordtracker.com/clue/van-gogh-had-one-later-in-life/
Ring bearer, maybe	crosswordtracker.com/clue/ring-bearer-maybe/
Musical discernment	crosswordtracker.com/clue/musical-discernment/
Hearing aid	crosswordtracker.com/clue/hearing-aid-1/
Teacup handle	crosswordtracker.com/clue/teacup-handle/
Toreador's trophy	crosswordtracker.com/clue/toreadors-trophy/
Musician's gift	crosswordtracker.com/clue/musicians-gift/
Cup handle	crosswordtracker.com/clue/cup-handle/
Stirrup site	crosswordtracker.com/clue/stirrup-site-1/
Pencil holder, at times	crosswordtracker.com/clue/pencil-holder-at-times/
"In one ___ and out the other"	crosswordtracker.com/clue/in-one-___-and-out-the-other-1/
___ canal	crosswordtracker.com/clue/___-canal-5/
Mr. Potato Head accessory	crosswordtracker.com/clue/mr-potato-head-accessory/
Ring locale	crosswordtracker.com/clue/ring-locale/
Corn plant part	crosswordtracker.com/clue/corn-plant-part/
Auditory apparatus	crosswordtracker.com/clue/auditory-apparatus/
Hammer and anvil site	crosswordtracker.com/clue/hammer-and-anvil-site/
Hoop site	crosswordtracker.com/clue/hoop-site/
Cereal spike	crosswordtracker.com/clue/cereal-spike/
Corn spike	crosswordtracker.com/clue/corn-spike/
Good listener?	crosswordtracker.com/clue/good-listener-1/
Barber's obstacle	crosswordtracker.com/clue/barbers-obstacle-1/
Stirrup's site	crosswordtracker.com/clue/stirrups-site/
A barber has to work around it	crosswordtracker.com/clue/a-barber-has-to-work-around-it/
Serving of corn	crosswordtracker.com/clue/serving-of-corn/
It may be lent or bent	crosswordtracker.com/clue/it-may-be-lent-or-bent/
Q-Tip target	crosswordtracker.com/clue/q-tip-target/
Sensitivity	crosswordtracker.com/clue/sensitivity/
Site for a drum	crosswordtracker.com/clue/site-for-a-drum/
Cochlea site	crosswordtracker.com/clue/cochlea-site-1/
Musical sensitivity	crosswordtracker.com/clue/musical-sensitivity/
Sense of pitch	crosswordtracker.com/clue/sense-of-pitch/
Musical asset	crosswordtracker.com/clue/musical-asset/
Ability to hit pitches?	crosswordtracker.com/clue/ability-to-hit-pitches/
Whisperer's target	crosswordtracker.com/clue/whisperers-target/
Phone attachment?	crosswordtracker.com/clue/phone-attachment/
Drum location	crosswordtracker.com/clue/drum-location/
Hole in the head?	crosswordtracker.com/clue/hole-in-the-head-1/
Cute as a bug's ___	crosswordtracker.com/clue/cute-as-a-bugs-___/
Flair for music	crosswordtracker.com/clue/flair-for-music/
Something to bend on a human	crosswordtracker.com/clue/something-to-bend-on-a-human/
Organ with a drum in it	crosswordtracker.com/clue/organ-with-a-drum-in-it/
A hoop may hang from it	crosswordtracker.com/clue/a-hoop-may-hang-from-it/
A friend may lend one	crosswordtracker.com/clue/a-friend-may-lend-one/
Affinity for music	crosswordtracker.com/clue/affinity-for-music/
Kernel holder	crosswordtracker.com/clue/kernel-holder/
Mr. Potato Head stick-on	crosswordtracker.com/clue/mr-potato-head-stick-on/
Pitcher feature	crosswordtracker.com/clue/pitcher-feature/
Hammer site	crosswordtracker.com/clue/hammer-site/
Listen here	crosswordtracker.com/clue/listen-here-1/
Labyrinth locale	crosswordtracker.com/clue/labyrinth-locale/
Sense of sound	crosswordtracker.com/clue/sense-of-sound/
Mr. Potato Head part	crosswordtracker.com/clue/mr-potato-head-part-1/
You can lend it or bend it	crosswordtracker.com/clue/you-can-lend-it-or-bend-it/
Keen perception	crosswordtracker.com/clue/keen-perception-1/
See above	crosswordtracker.com/clue/see-above/
Head part	crosswordtracker.com/clue/head-part/
Lend it or bend it	crosswordtracker.com/clue/lend-it-or-bend-it/
Tympanic membrane site	crosswordtracker.com/clue/tympanic-membrane-site/
Hearing organ	crosswordtracker.com/clue/hearing-organ/
You might play something by it	crosswordtracker.com/clue/you-might-play-something-by-it/
Site of semicircular canals	crosswordtracker.com/clue/site-of-semicircular-canals/
Organ of equilibrium	crosswordtracker.com/clue/organ-of-equilibrium/
Lobe site	crosswordtracker.com/clue/lobe-site/
Part of ENT	crosswordtracker.com/clue/part-of-ent/
Labyrinth location	crosswordtracker.com/clue/labyrinth-location/
A barber might nick it	crosswordtracker.com/clue/a-barber-might-nick-it/
Site of the smallest bone in the body	crosswordtracker.com/clue/site-of-the-smallest-bone-in-the-body/
Auditory organ	crosswordtracker.com/clue/auditory-organ/
Stud setting	crosswordtracker.com/clue/stud-setting/
Hear here	crosswordtracker.com/clue/hear-here/
Spot for a stud	crosswordtracker.com/clue/spot-for-a-stud/
Distinctive Vulcan feature	crosswordtracker.com/clue/distinctive-vulcan-feature/
Van Gogh's loss	crosswordtracker.com/clue/van-goghs-loss/
Ability to distinguish pitch	crosswordtracker.com/clue/ability-to-distinguish-pitch/
Van Gogh had one in his later years	crosswordtracker.com/clue/van-gogh-had-one-in-his-later-years/
Ability to discern good music	crosswordtracker.com/clue/ability-to-discern-good-music/
Unit of corn	crosswordtracker.com/clue/unit-of-corn/
Stirrup location	crosswordtracker.com/clue/stirrup-location/
Wax collector	crosswordtracker.com/clue/wax-collector/
Folded corner	crosswordtracker.com/clue/folded-corner/
Tin ___	crosswordtracker.com/clue/tin-___/
Plug place	crosswordtracker.com/clue/plug-place-1/
Stud's place	crosswordtracker.com/clue/studs-place/
Ring location?	crosswordtracker.com/clue/ring-location/
Aural organ	crosswordtracker.com/clue/aural-organ/
Jug part	crosswordtracker.com/clue/jug-part/
Maestro's gift	crosswordtracker.com/clue/maestros-gift/
Hammer home?	crosswordtracker.com/clue/hammer-home-1/
Swab target	crosswordtracker.com/clue/swab-target/
Lug of a jug	crosswordtracker.com/clue/lug-of-a-jug/
Corn cob	crosswordtracker.com/clue/corn-cob/
Crossette	crosswordtracker.com/clue/crossette/
Matador's trophy	crosswordtracker.com/clue/matadors-trophy/
Piercing locale	crosswordtracker.com/clue/piercing-locale/
Hoop locale	crosswordtracker.com/clue/hoop-locale/
Word with muff or flap	crosswordtracker.com/clue/word-with-muff-or-flap/
Pinna's place	crosswordtracker.com/clue/pinnas-place/
__ candy (pleasing music)	crosswordtracker.com/clue/__-candy-pleasing-music/
It can be swabbed	crosswordtracker.com/clue/it-can-be-swabbed/
Anvil setting	crosswordtracker.com/clue/anvil-setting/
Hoop holder	crosswordtracker.com/clue/hoop-holder/
Where to find a cochlea	crosswordtracker.com/clue/where-to-find-a-cochlea/
Stirrup setting	crosswordtracker.com/clue/stirrup-setting/
Anvil and stirrup site	crosswordtracker.com/clue/anvil-and-stirrup-site/
Musical perception	crosswordtracker.com/clue/musical-perception/
Sound detector	crosswordtracker.com/clue/sound-detector/
Pitcher handle	crosswordtracker.com/clue/pitcher-handle/
Listening organ	crosswordtracker.com/clue/listening-organ/
You may lend it or bend it	crosswordtracker.com/clue/you-may-lend-it-or-bend-it/
Corncrib item	crosswordtracker.com/clue/corncrib-item/
Aptitude for note-worthy creations?	crosswordtracker.com/clue/aptitude-for-note-worthy-creations/
Pencil holder, sometimes	crosswordtracker.com/clue/pencil-holder-sometimes/
Where to find a hammer or anvil	crosswordtracker.com/clue/where-to-find-a-hammer-or-anvil/
Din detector	crosswordtracker.com/clue/din-detector/
It's near a temple	crosswordtracker.com/clue/its-near-a-temple/
Mr. Spock's had a point	crosswordtracker.com/clue/mr-spocks-had-a-point/
Hearing need	crosswordtracker.com/clue/hearing-need/
Pencil holder?	crosswordtracker.com/clue/pencil-holder-4/
Auditory canal locale	crosswordtracker.com/clue/auditory-canal-locale/
Auditory nerve's locale	crosswordtracker.com/clue/auditory-nerves-locale/
Sound sense	crosswordtracker.com/clue/sound-sense/
Cerumen locale	crosswordtracker.com/clue/cerumen-locale/
Pencil parking place	crosswordtracker.com/clue/pencil-parking-place/
Wax container	crosswordtracker.com/clue/wax-container/
Place for jewelry	crosswordtracker.com/clue/place-for-jewelry/
''In one ___ and out the other''	crosswordtracker.com/clue/in-one-___-and-out-the-other/
A cricket has one below each front leg joint	crosswordtracker.com/clue/a-cricket-has-one-below-each-front-leg-joint/
Wax trapper	crosswordtracker.com/clue/wax-trapper/
Where the smallest bones in the body are located	crosswordtracker.com/clue/where-the-smallest-bones-in-the-body-are-located/
Musical acuity	crosswordtracker.com/clue/musical-acuity/
Corny bit?	crosswordtracker.com/clue/corny-bit/
Hammer and anvil setting	crosswordtracker.com/clue/hammer-and-anvil-setting/
Musical knack	crosswordtracker.com/clue/musical-knack/
Traditionalist's piercing site	crosswordtracker.com/clue/traditionalists-piercing-site/
Organ with a drum inside	crosswordtracker.com/clue/organ-with-a-drum-inside/
Musical skill	crosswordtracker.com/clue/musical-skill/
Big beagle feature	crosswordtracker.com/clue/big-beagle-feature/
Either end of a wide grin	crosswordtracker.com/clue/either-end-of-a-wide-grin/
Big part of an elephant	crosswordtracker.com/clue/big-part-of-an-elephant/
Something that may be pricked	crosswordtracker.com/clue/something-that-may-be-pricked/
Wave catcher?	crosswordtracker.com/clue/wave-catcher/
Inner ___	crosswordtracker.com/clue/inner-___/
Plug's place	crosswordtracker.com/clue/plugs-place/
Big feature of an elephant	crosswordtracker.com/clue/big-feature-of-an-elephant/
Pencil holder	crosswordtracker.com/clue/pencil-holder-5/
Conductor's need	crosswordtracker.com/clue/conductors-need/
Floppy rabbit feature	crosswordtracker.com/clue/floppy-rabbit-feature/
Drum holder	crosswordtracker.com/clue/drum-holder/
__ candy	crosswordtracker.com/clue/__-candy-1/
Pierced organ	crosswordtracker.com/clue/pierced-organ/
Van Gogh lost one	crosswordtracker.com/clue/van-gogh-lost-one/
Dumbo's wing	crosswordtracker.com/clue/dumbos-wing-3/
Pencil-parking place	crosswordtracker.com/clue/pencil-parking-place-1/
Drum locale	crosswordtracker.com/clue/drum-locale/
Corn measure	crosswordtracker.com/clue/corn-measure/
You may eavesdrop with it	crosswordtracker.com/clue/you-may-eavesdrop-with-it/
"... silk purse out of a sow's ___"	crosswordtracker.com/clue/silk-purse-out-of-a-sows-___-1/
Musician's need	crosswordtracker.com/clue/musicians-need/
Prominent dachshund feature	crosswordtracker.com/clue/prominent-dachshund-feature/
Sound processor	crosswordtracker.com/clue/sound-processor/
Barber's obstruction	crosswordtracker.com/clue/barbers-obstruction/
It may be pulled in charades	crosswordtracker.com/clue/it-may-be-pulled-in-charades/
Ring spot	crosswordtracker.com/clue/ring-spot/
It may be lent	crosswordtracker.com/clue/it-may-be-lent/
Place to hang a ring	crosswordtracker.com/clue/place-to-hang-a-ring/
Corn amount	crosswordtracker.com/clue/corn-amount/
Cochlea location	crosswordtracker.com/clue/cochlea-location/
This has a vestibule	crosswordtracker.com/clue/this-has-a-vestibule/
Anvil location	crosswordtracker.com/clue/anvil-location/
Spike of corn	crosswordtracker.com/clue/spike-of-corn/
Hammer's location	crosswordtracker.com/clue/hammers-location/
Cochlea's locale	crosswordtracker.com/clue/cochleas-locale/
Perceptive faculty	crosswordtracker.com/clue/perceptive-faculty/
Front-page box	crosswordtracker.com/clue/front-page-box-1/
Antony's loan request	crosswordtracker.com/clue/antonys-loan-request-1/
Concha	crosswordtracker.com/clue/concha-1/
Teacup part	crosswordtracker.com/clue/teacup-part/
Cereal-plant part	crosswordtracker.com/clue/cereal-plant-part/
Clip-on locale	crosswordtracker.com/clue/clip-on-locale/
Bud's spot	crosswordtracker.com/clue/buds-spot/
Swabbed spot	crosswordtracker.com/clue/swabbed-spot/
Musicians gift	crosswordtracker.com/clue/musicians-gift-1/
Listening device?	crosswordtracker.com/clue/listening-device-2/
Sensor	crosswordtracker.com/clue/sensor-8/
Listen here!	crosswordtracker.com/clue/listen-here-2/
Mr. Potato Head attachment	crosswordtracker.com/clue/mr-potato-head-attachment/
A tuner's asset	crosswordtracker.com/clue/a-tuners-asset/
It may be pulled or bent	crosswordtracker.com/clue/it-may-be-pulled-or-bent/
Sense organ	crosswordtracker.com/clue/sense-organ/
Piece of corn	crosswordtracker.com/clue/piece-of-corn-1/
Type of phone	crosswordtracker.com/clue/type-of-phone/
Full attention	crosswordtracker.com/clue/full-attention/
Cochlea locale	crosswordtracker.com/clue/cochlea-locale/
Place for a hammer	crosswordtracker.com/clue/place-for-a-hammer/
Musical attunement	crosswordtracker.com/clue/musical-attunement/
Melodic sense	crosswordtracker.com/clue/melodic-sense/
Add one letter, and you have an explanation of what it does	crosswordtracker.com/clue/add-one-letter-and-you-have-an-explanation-of-what-it-does/
Drum and canal locale	crosswordtracker.com/clue/drum-and-canal-locale/
Ability to hear notes	crosswordtracker.com/clue/ability-to-hear-notes/
ENT part	crosswordtracker.com/clue/ent-part/
Aural aptitude	crosswordtracker.com/clue/aural-aptitude/
Knack for notes	crosswordtracker.com/clue/knack-for-notes/
Word with mark or muff	crosswordtracker.com/clue/word-with-mark-or-muff/
Organ for an otolaryngologist	crosswordtracker.com/clue/organ-for-an-otolaryngologist/
Pencil holder, often	crosswordtracker.com/clue/pencil-holder-often/
It's used when looking for the right key	crosswordtracker.com/clue/its-used-when-looking-for-the-right-key/
Ossicles' site	crosswordtracker.com/clue/ossicles-site/
Temple neighbor	crosswordtracker.com/clue/temple-neighbor/
Glasses support	crosswordtracker.com/clue/glasses-support/
Where the incus bone is	crosswordtracker.com/clue/where-the-incus-bone-is/
Word with canal or drum	crosswordtracker.com/clue/word-with-canal-or-drum/
Thermometer insertion point, perhaps	crosswordtracker.com/clue/thermometer-insertion-point-perhaps/
Crooner's asset	crosswordtracker.com/clue/crooners-asset/
It's used to find the right key	crosswordtracker.com/clue/its-used-to-find-the-right-key/
Cob + kernels	crosswordtracker.com/clue/cob-kernels/
Anvil site	crosswordtracker.com/clue/anvil-site/
Otic organ	crosswordtracker.com/clue/otic-organ/
Word with ''mark'' or ''splitting''	crosswordtracker.com/clue/word-with-mark-or-splitting/
Organ with a lobe	crosswordtracker.com/clue/organ-with-a-lobe/
Tonal sense	crosswordtracker.com/clue/tonal-sense/
Lend an __ (listen)	crosswordtracker.com/clue/lend-an-__-listen/
Sound catcher	crosswordtracker.com/clue/sound-catcher/
Cellist's gift	crosswordtracker.com/clue/cellists-gift/
It has its own drum	crosswordtracker.com/clue/it-has-its-own-drum/
It's part of a head	crosswordtracker.com/clue/its-part-of-a-head/
Word with drops or canal	crosswordtracker.com/clue/word-with-drops-or-canal/
Spike in a field	crosswordtracker.com/clue/spike-in-a-field/
Word with muff or mark	crosswordtracker.com/clue/word-with-muff-or-mark/
It may be pierced	crosswordtracker.com/clue/it-may-be-pierced/
Spike in a grain field	crosswordtracker.com/clue/spike-in-a-grain-field/
Stirrup spot	crosswordtracker.com/clue/stirrup-spot/
Cobful of corn	crosswordtracker.com/clue/cobful-of-corn/
Word with "flap" or "drum"	crosswordtracker.com/clue/word-with-flap-or-drum/
Organ with a hammer	crosswordtracker.com/clue/organ-with-a-hammer/
Organ near a temple?	crosswordtracker.com/clue/organ-near-a-temple/
Hammer-and-anvil site	crosswordtracker.com/clue/hammer-and-anvil-site-1/
Semicircular-canal site	crosswordtracker.com/clue/semicircular-canal-site/
Van Gogh wound up with one	crosswordtracker.com/clue/van-gogh-wound-up-with-one/
Organ with a canal	crosswordtracker.com/clue/organ-with-a-canal/
Major elephant feature	crosswordtracker.com/clue/major-elephant-feature/
It can be pierced or plugged	crosswordtracker.com/clue/it-can-be-pierced-or-plugged/
Prominent part of Mickey's silhouette	crosswordtracker.com/clue/prominent-part-of-mickeys-silhouette/
Head extension?	crosswordtracker.com/clue/head-extension/
It can be pierced or pricked up	crosswordtracker.com/clue/it-can-be-pierced-or-pricked-up/
Plug place, perhaps	crosswordtracker.com/clue/plug-place-perhaps/
Keen perception, musically	crosswordtracker.com/clue/keen-perception-musically/
Word after dog or tin	crosswordtracker.com/clue/word-after-dog-or-tin/
It's cupped to catch a whisper	crosswordtracker.com/clue/its-cupped-to-catch-a-whisper/
Plug setting?	crosswordtracker.com/clue/plug-setting/
It's inside a husk	crosswordtracker.com/clue/its-inside-a-husk/
Tin organ?	crosswordtracker.com/clue/tin-organ/
It may be ringed or ringing	crosswordtracker.com/clue/it-may-be-ringed-or-ringing/
Word before phone or ring	crosswordtracker.com/clue/word-before-phone-or-ring/
Mike Tyson's 1997 mouthpiece?	crosswordtracker.com/clue/mike-tysons-1997-mouthpiece/
Dumbo's "wing"	crosswordtracker.com/clue/dumbos-wing-2/
Lead-in to ring or drum	crosswordtracker.com/clue/lead-in-to-ring-or-drum/
Word with wax or phone	crosswordtracker.com/clue/word-with-wax-or-phone/
Traditional piercing site	crosswordtracker.com/clue/traditional-piercing-site/
Drop target, sometimes	crosswordtracker.com/clue/drop-target-sometimes/
Locale of a small stirrup	crosswordtracker.com/clue/locale-of-a-small-stirrup/
Auditory sensor	crosswordtracker.com/clue/auditory-sensor/
Wax manufacturer	crosswordtracker.com/clue/wax-manufacturer/
Anvil locale	crosswordtracker.com/clue/anvil-locale/
Wheat spike	crosswordtracker.com/clue/wheat-spike/
Word with ''drop'' or ''drum''	crosswordtracker.com/clue/word-with-drop-or-drum/
It may ring or have a ring	crosswordtracker.com/clue/it-may-ring-or-have-a-ring/
Type of wax	crosswordtracker.com/clue/type-of-wax/
Organ near the temple	crosswordtracker.com/clue/organ-near-the-temple/
Something to lend a storyteller?	crosswordtracker.com/clue/something-to-lend-a-storyteller/
Shucked item	crosswordtracker.com/clue/shucked-item/
Topic of corn-versation?	crosswordtracker.com/clue/topic-of-corn-versation/
Thing to bend or lend	crosswordtracker.com/clue/thing-to-bend-or-lend/
Spot for a hammer in the head	crosswordtracker.com/clue/spot-for-a-hammer-in-the-head/
Musical aptitude, of a sort	crosswordtracker.com/clue/musical-aptitude-of-a-sort/
Play by ___ (without sheet music)	crosswordtracker.com/clue/play-by-___-without-sheet-music/
Sideburn neighbor	crosswordtracker.com/clue/sideburn-neighbor/
Ability to appreciate music	crosswordtracker.com/clue/ability-to-appreciate-music/
Van Gogh's missing piece?	crosswordtracker.com/clue/van-goghs-missing-piece/
Where you'll find a stirrup	crosswordtracker.com/clue/where-youll-find-a-stirrup/
Eustachian tube locale	crosswordtracker.com/clue/eustachian-tube-locale/
A pencil may be parked behind here	crosswordtracker.com/clue/a-pencil-may-be-parked-behind-here/
Song played at the school dance in "Back to the Future"	crosswordtracker.com/clue/song-played-at-the-school-dance-in-back-to-the-future/
Place to put a bud	crosswordtracker.com/clue/place-to-put-a-bud/
Pink Mr. Potato Head piece	crosswordtracker.com/clue/pink-mr-potato-head-piece/
You might play something by this	crosswordtracker.com/clue/you-might-play-something-by-this/
Elephant's-___ (plant)	crosswordtracker.com/clue/elephants-___-plant/
Where to hold a telephone receiver	crosswordtracker.com/clue/where-to-hold-a-telephone-receiver/
Improviser's asset	crosswordtracker.com/clue/improvisers-asset/
Van Gogh had one	crosswordtracker.com/clue/van-gogh-had-one-2/
Ring holder ... or receiver?	crosswordtracker.com/clue/ring-holder-or-receiver/
What a barber has to trim around	crosswordtracker.com/clue/what-a-barber-has-to-trim-around/
Place for a headphone	crosswordtracker.com/clue/place-for-a-headphone/
Prominent donkey feature	crosswordtracker.com/clue/prominent-donkey-feature-1/
Tarsus : foot :: incus : ___	crosswordtracker.com/clue/tarsus-foot-incus-___/
Obstacle for a barber	crosswordtracker.com/clue/obstacle-for-a-barber/
It may pop on a plane	crosswordtracker.com/clue/it-may-pop-on-a-plane/
It might get a plug	crosswordtracker.com/clue/it-might-get-a-plug/
It may be floppy or pointy	crosswordtracker.com/clue/it-may-be-floppy-or-pointy/
What an aurilave cleans	crosswordtracker.com/clue/what-an-aurilave-cleans/
There can be a ring in it or on it	crosswordtracker.com/clue/there-can-be-a-ring-in-it-or-on-it/
It may be cocked or cupped	crosswordtracker.com/clue/it-may-be-cocked-or-cupped/
Human body part with vestigial muscles	crosswordtracker.com/clue/human-body-part-with-vestigial-muscles/
Where the utricle is	crosswordtracker.com/clue/where-the-utricle-is/
Where the antihelix is	crosswordtracker.com/clue/where-the-antihelix-is/
Prominent Chihuahua feature	crosswordtracker.com/clue/prominent-chihuahua-feature-1/
___ candy (some pop tunes)	crosswordtracker.com/clue/___-candy-some-pop-tunes/
Iowa harvest unit	crosswordtracker.com/clue/iowa-harvest-unit/
Audiologist's concern	crosswordtracker.com/clue/audiologists-concern/
It may be cupped or cuffed	crosswordtracker.com/clue/it-may-be-cupped-or-cuffed/
A hoop may be attached to it	crosswordtracker.com/clue/a-hoop-may-be-attached-to-it/
Pitching asset?	crosswordtracker.com/clue/pitching-asset/
Eustachian tube site	crosswordtracker.com/clue/eustachian-tube-site/
It may be sympathetic	crosswordtracker.com/clue/it-may-be-sympathetic/
___ candy (pop music)	crosswordtracker.com/clue/___-candy-pop-music/
Grin's boundary, so it's said	crosswordtracker.com/clue/grins-boundary-so-its-said/
End point for an iPod cord	crosswordtracker.com/clue/end-point-for-an-ipod-cord/
It's often next to a phone	crosswordtracker.com/clue/its-often-next-to-a-phone/
What barotrauma affects	crosswordtracker.com/clue/what-barotrauma-affects/
Prominent part of a dachshund	crosswordtracker.com/clue/prominent-part-of-a-dachshund/
Sound system component?	crosswordtracker.com/clue/sound-system-component-1/
Place for a stirrup	crosswordtracker.com/clue/place-for-a-stirrup/
Where a phone is held	crosswordtracker.com/clue/where-a-phone-is-held/
Side flap	crosswordtracker.com/clue/side-flap/
Big elephant feature	crosswordtracker.com/clue/big-elephant-feature/
It's needed to find the right key	crosswordtracker.com/clue/its-needed-to-find-the-right-key/
"Lent" body part	crosswordtracker.com/clue/lent-body-part/
    Word with candy or drops	crosswordtracker.com/clue/word-with-candy-or-drops/
Otologist's focus	crosswordtracker.com/clue/otologists-focus/
Word before canal or candy	crosswordtracker.com/clue/word-before-canal-or-candy/
Bud's place	crosswordtracker.com/clue/buds-place/
Word with "drop" or "drum"	crosswordtracker.com/clue/word-with-drop-or-drum-1/
Elephant's ___ (plant)	crosswordtracker.com/clue/elephants-___-plant-1/
Makeshift pencil holder	crosswordtracker.com/clue/makeshift-pencil-holder-1/
Tyson's infamous biting target	crosswordtracker.com/clue/tysons-infamous-biting-target/
Poor listener's in-and-out organ	crosswordtracker.com/clue/poor-listeners-in-and-out-organ/
Tin ___ (lack of musical sense)	crosswordtracker.com/clue/tin-___-lack-of-musical-sense/
"... silk purse out of a sows ___"	crosswordtracker.com/clue/silk-purse-out-of-a-sows-___/
Musical sound receiver	crosswordtracker.com/clue/musical-sound-receiver/
It can ache	crosswordtracker.com/clue/it-can-ache/
Acoustic organ?	crosswordtracker.com/clue/acoustic-organ-1/
Bionic part of the Bionic Woman	crosswordtracker.com/clue/bionic-part-of-the-bionic-woman/
It's beside a sideburn	crosswordtracker.com/clue/its-beside-a-sideburn/
Pointy Spock feature	crosswordtracker.com/clue/pointy-spock-feature/
It contains a human drum	crosswordtracker.com/clue/it-contains-a-human-drum/
Hoop spot	crosswordtracker.com/clue/hoop-spot/
Shape of orecchietta pasta	crosswordtracker.com/clue/shape-of-orecchietta-pasta/
Tuner's talent	crosswordtracker.com/clue/tuners-talent/
Van Gogh: ___ today, gone tomorrow?	crosswordtracker.com/clue/van-gogh-___-today-gone-tomorrow/
Place to put a plug	crosswordtracker.com/clue/place-to-put-a-plug/
Plant's grain-bearing part	crosswordtracker.com/clue/plants-grain-bearing-part/
Where the smallest human bone is	crosswordtracker.com/clue/where-the-smallest-human-bone-is/
Place for some plugs	crosswordtracker.com/clue/place-for-some-plugs/
Hammer home	crosswordtracker.com/clue/hammer-home/
". . . silk purse out of a sow's ___"	crosswordtracker.com/clue/silk-purse-out-of-a-sows-___-2/
Hearing device	crosswordtracker.com/clue/hearing-device/
Floppy feature of a basset hound	crosswordtracker.com/clue/floppy-feature-of-a-basset-hound/
Big part of a hare	crosswordtracker.com/clue/big-part-of-a-hare/
Van Gogh pun: ___ today, gone tomorrow?	crosswordtracker.com/clue/van-gogh-pun-___-today-gone-tomorrow/
Bud's beginning	crosswordtracker.com/clue/buds-beginning/
Organ of hearing	crosswordtracker.com/clue/organ-of-hearing/
Lent part?	crosswordtracker.com/clue/lent-part/
Otologist's study	crosswordtracker.com/clue/otologists-study/
Word with drum or trumpet	crosswordtracker.com/clue/word-with-drum-or-trumpet/
One sense, figuratively	crosswordtracker.com/clue/one-sense-figuratively/
Kind of drum or trumpet	crosswordtracker.com/clue/kind-of-drum-or-trumpet/
Object near a temple	crosswordtracker.com/clue/object-near-a-temple/
Cereal plant portion	crosswordtracker.com/clue/cereal-plant-portion/
It sticks out at the side	crosswordtracker.com/clue/it-sticks-out-at-the-side/
Spot for a headphone	crosswordtracker.com/clue/spot-for-a-headphone/
Music appreciation	crosswordtracker.com/clue/music-appreciation-1/
Corn order	crosswordtracker.com/clue/corn-order/
Hairstylist's obstacle?	crosswordtracker.com/clue/hairstylists-obstacle/
Organ that's sensitive to vibrations	crosswordtracker.com/clue/organ-thats-sensitive-to-vibrations/
Swimmer's ___ (medical ailment)	crosswordtracker.com/clue/swimmers-___-medical-ailment/
Corn purchase	crosswordtracker.com/clue/corn-purchase/
Stalk outgrowth	crosswordtracker.com/clue/stalk-outgrowth/
Something to shuck	crosswordtracker.com/clue/something-to-shuck/
Put an H in front of it to make something you can do with it	crosswordtracker.com/clue/put-an-h-in-front-of-it-to-make-something-you-can-do-with-it/
Kernel carrier	crosswordtracker.com/clue/kernel-carrier/
Musician's pride	crosswordtracker.com/clue/musicians-pride/
Site of a helix and antihelix	crosswordtracker.com/clue/site-of-a-helix-and-antihelix/
Spot for a ring	crosswordtracker.com/clue/spot-for-a-ring/
Beagle's drooper	crosswordtracker.com/clue/beagles-drooper/
What a headphone goes over	crosswordtracker.com/clue/what-a-headphone-goes-over/
Big grin stopping point?	crosswordtracker.com/clue/big-grin-stopping-point/
Part of E.N.T.	crosswordtracker.com/clue/part-of-ent-1/
Van Gogh's love offering	crosswordtracker.com/clue/van-goghs-love-offering/
Word with "wig," "wax" or "ring"	crosswordtracker.com/clue/word-with-wig-wax-or-ring/
What a barber must cut around	crosswordtracker.com/clue/what-a-barber-must-cut-around/
Prominent part of a basset hound	crosswordtracker.com/clue/prominent-part-of-a-basset-hound/
Noise detector	crosswordtracker.com/clue/noise-detector/
Abalone shape	crosswordtracker.com/clue/abalone-shape/
Trumpet locale	crosswordtracker.com/clue/trumpet-locale/
Muff site	crosswordtracker.com/clue/muff-site/
Where the incus is	crosswordtracker.com/clue/where-the-incus-is/
Canal zone	crosswordtracker.com/clue/canal-zone-6/
Musician's attribute	crosswordtracker.com/clue/musicians-attribute/
Item lent to Antony	crosswordtracker.com/clue/item-lent-to-antony/
Part of E.E.N.T.	crosswordtracker.com/clue/part-of-eent/
Auditory appendage	crosswordtracker.com/clue/auditory-appendage/
Anvil's locale	crosswordtracker.com/clue/anvils-locale/
Musician's sine qua non	crosswordtracker.com/clue/musicians-sine-qua-non/
The "E" in E.N.T.	crosswordtracker.com/clue/the-e-in-ent/
Architectural crossette	crosswordtracker.com/clue/architectural-crossette/
Grin's stopping point	crosswordtracker.com/clue/grins-stopping-point/
Catch one's _____	crosswordtracker.com/clue/catch-ones-_____/
A muff covers it	crosswordtracker.com/clue/a-muff-covers-it/
Kernel's locale	crosswordtracker.com/clue/kernels-locale/
"At each ___ a hearer": Hamlet	crosswordtracker.com/clue/at-each-___-a-hearer-hamlet/
Otology subject	crosswordtracker.com/clue/otology-subject/
Aural appendage	crosswordtracker.com/clue/aural-appendage/
Sideburn's neighbor	crosswordtracker.com/clue/sideburns-neighbor/
Hearing shell	crosswordtracker.com/clue/hearing-shell/
Iowa farm item	crosswordtracker.com/clue/iowa-farm-item/
Word with phone or trumpet	crosswordtracker.com/clue/word-with-phone-or-trumpet/
Anvil and hammer site	crosswordtracker.com/clue/anvil-and-hammer-site/
Symbol of attentiveness	crosswordtracker.com/clue/symbol-of-attentiveness/
Otologist's specialty	crosswordtracker.com/clue/otologists-specialty/
Sound perception	crosswordtracker.com/clue/sound-perception/
Pinna's organ	crosswordtracker.com/clue/pinnas-organ/
Type of trumpet	crosswordtracker.com/clue/type-of-trumpet/
Site of the cochlea	crosswordtracker.com/clue/site-of-the-cochlea/
Cochlea's site	crosswordtracker.com/clue/cochleas-site/
Kind of plug or bud	crosswordtracker.com/clue/kind-of-plug-or-bud/
Prominent part of a bat	crosswordtracker.com/clue/prominent-part-of-a-bat/
Noggin protrusion	crosswordtracker.com/clue/noggin-protrusion/
What otitis media affects	crosswordtracker.com/clue/what-otitis-media-affects/
Its often on an iPhones screen	crosswordtracker.com/clue/its-often-on-an-iphones-screen/
What the blind man who thought the elephant was "like a fan" touched	crosswordtracker.com/clue/what-the-blind-man-who-thought-the-elephant-was-like-a-fan-touched/
Otoplasty target	crosswordtracker.com/clue/otoplasty-target/
Jaime Sommers had a bionic one	crosswordtracker.com/clue/jaime-sommers-had-a-bionic-one/
Anvil's setting	crosswordtracker.com/clue/anvils-setting/
Body part to lend or bend	crosswordtracker.com/clue/body-part-to-lend-or-bend/
Keep an ___ to the ground	crosswordtracker.com/clue/keep-an-___-to-the-ground/
Hoop holder, maybe	crosswordtracker.com/clue/hoop-holder-maybe/
It can be lent or bent	crosswordtracker.com/clue/it-can-be-lent-or-bent/
Cerumen's spot	crosswordtracker.com/clue/cerumens-spot/
"You can't make a silk purse out of a sow's ___"	crosswordtracker.com/clue/you-cant-make-a-silk-purse-out-of-a-sows-___/
Locale of a tiny stirrup	crosswordtracker.com/clue/locale-of-a-tiny-stirrup/
Pointy body part on a Vulcan	crosswordtracker.com/clue/pointy-body-part-on-a-vulcan/
Stud's spot	crosswordtracker.com/clue/studs-spot/
Swimmer's ___	crosswordtracker.com/clue/swimmers-___-2/
Subject of otology	crosswordtracker.com/clue/subject-of-otology/
Holder of kernels	crosswordtracker.com/clue/holder-of-kernels/
"___-Resistible" (Temptations album)	crosswordtracker.com/clue/___-resistible-temptations-album/
Cochlear implant site	crosswordtracker.com/clue/cochlear-implant-site/
It's found near a temple	crosswordtracker.com/clue/its-found-near-a-temple/
Stirrup's spot	crosswordtracker.com/clue/stirrups-spot/
Thing pulled when playing charades	crosswordtracker.com/clue/thing-pulled-when-playing-charades/
Corn quantity	crosswordtracker.com/clue/corn-quantity/
Pencil holder, perhaps	crosswordtracker.com/clue/pencil-holder-perhaps/
Place for waxy buildup	crosswordtracker.com/clue/place-for-waxy-buildup/
It's lent for support	crosswordtracker.com/clue/its-lent-for-support/
Otitis location	crosswordtracker.com/clue/otitis-location/
Body part associated with Van Gogh	crosswordtracker.com/clue/body-part-associated-with-van-gogh/
Place to find a stud?	crosswordtracker.com/clue/place-to-find-a-stud-1/
Hoop site, maybe	crosswordtracker.com/clue/hoop-site-maybe/
Musician's gift?	crosswordtracker.com/clue/musicians-gift-2/
Lend an ___	crosswordtracker.com/clue/lend-an-___/
Lend an ____	crosswordtracker.com/clue/lend-an-____/
Corn container?	crosswordtracker.com/clue/corn-container-4/
____ Falls, Ontario	crosswordtracker.com/clue/____-falls-ontario/
Musical cognizance	crosswordtracker.com/clue/musical-cognizance/
A musical talent	crosswordtracker.com/clue/a-musical-talent/
Lend an _____	crosswordtracker.com/clue/lend-an-_____/
Part of a corn plant	crosswordtracker.com/clue/part-of-a-corn-plant/
Spike, as of grain	crosswordtracker.com/clue/spike-as-of-grain/
Oft-pierced body part	crosswordtracker.com/clue/oft-pierced-body-part/
Trophy handle	crosswordtracker.com/clue/trophy-handle/
Musician's boon	crosswordtracker.com/clue/musicians-boon/
Musical acumen	crosswordtracker.com/clue/musical-acumen/
Place for a small drum?	crosswordtracker.com/clue/place-for-a-small-drum/
Equilibrium provider	crosswordtracker.com/clue/equilibrium-provider/
It's laid back on an angry horse	crosswordtracker.com/clue/its-laid-back-on-an-angry-horse/
Vulcan feature	crosswordtracker.com/clue/vulcan-feature/
Hammer's home	crosswordtracker.com/clue/hammers-home/
It helps keep one balanced	crosswordtracker.com/clue/it-helps-keep-one-balanced/
Word before drop or drum	crosswordtracker.com/clue/word-before-drop-or-drum/
Cerumen site	crosswordtracker.com/clue/cerumen-site/
One place to find a hammer	crosswordtracker.com/clue/one-place-to-find-a-hammer/
Van Gogh's sacrifice	crosswordtracker.com/clue/van-goghs-sacrifice/
Cauliflower ---	crosswordtracker.com/clue/cauliflower--2/
Big grin terminus?	crosswordtracker.com/clue/big-grin-terminus/
Big grin stopping point	crosswordtracker.com/clue/big-grin-stopping-point-1/
Holyfield's got Tyson into trouble	crosswordtracker.com/clue/holyfields-got-tyson-into-trouble/
PassÃ© piercing option, nowadays	crosswordtracker.com/clue/passa-piercing-option-nowadays/
Listener's loan	crosswordtracker.com/clue/listeners-loan/
Lendable organ	crosswordtracker.com/clue/lendable-organ/
Corrida trophy	crosswordtracker.com/clue/corrida-trophy/
Trophy part	crosswordtracker.com/clue/trophy-part/
From whence to lug a jug	crosswordtracker.com/clue/from-whence-to-lug-a-jug/
Aural factory?	crosswordtracker.com/clue/aural-factory/
Kernel site	crosswordtracker.com/clue/kernel-site/
Head protrusion	crosswordtracker.com/clue/head-protrusion/
Part of a teacup	crosswordtracker.com/clue/part-of-a-teacup/
Word before drop or flap	crosswordtracker.com/clue/word-before-drop-or-flap/
Husker's handful	crosswordtracker.com/clue/huskers-handful/
''In one __ and out . . .''	crosswordtracker.com/clue/in-one-__-and-out/
It's bent by a bore	crosswordtracker.com/clue/its-bent-by-a-bore/
Canal location	crosswordtracker.com/clue/canal-location/
Labyrinth setting	crosswordtracker.com/clue/labyrinth-setting/
Sympathetic one's offering	crosswordtracker.com/clue/sympathetic-ones-offering/
Canal setting	crosswordtracker.com/clue/canal-setting/
Ring bearer, at times	crosswordtracker.com/clue/ring-bearer-at-times/
Place to whisper sweet nothings	crosswordtracker.com/clue/place-to-whisper-sweet-nothings/
Drum organ	crosswordtracker.com/clue/drum-organ/
It's lent by friends	crosswordtracker.com/clue/its-lent-by-friends/
"In one ___ and out ..."	crosswordtracker.com/clue/in-one-___-and-out-2/
Musical appreciation	crosswordtracker.com/clue/musical-appreciation/
One may be bent	crosswordtracker.com/clue/one-may-be-bent/
It's connected to the Eustachian tube	crosswordtracker.com/clue/its-connected-to-the-eustachian-tube/
Word before "buds"	crosswordtracker.com/clue/word-before-buds/
Tyson nugget?	crosswordtracker.com/clue/tyson-nugget/
Musical aptitude, as it were	crosswordtracker.com/clue/musical-aptitude-as-it-were/
Barbecue side dish unit	crosswordtracker.com/clue/barbecue-side-dish-unit/
Perfect pitch organ	crosswordtracker.com/clue/perfect-pitch-organ/
Mike Tyson's in-fight snack	crosswordtracker.com/clue/mike-tysons-in-fight-snack/
Elephant feature	crosswordtracker.com/clue/elephant-feature/
It helps hold glasses	crosswordtracker.com/clue/it-helps-hold-glasses/
Discernment of a sort	crosswordtracker.com/clue/discernment-of-a-sort/
Place for a small hammer	crosswordtracker.com/clue/place-for-a-small-hammer/
Word with "muff" or "mark"	crosswordtracker.com/clue/word-with-muff-or-mark-1/
Musical ability	crosswordheaven.com/clues/musical-ability
Canal site	crosswordheaven.com/clues/canal-site
Pitcher part	crosswordheaven.com/clues/pitcher-part
Kernel carrier	crosswordheaven.com/clues/kernel-carrier
It may be pulled in charades	crosswordheaven.com/clues/it-may-be-pulled-in-charades
Corn serving	crosswordheaven.com/clues/corn-serving
Listening device	crosswordheaven.com/clues/listening-device
Barber's obstruction	crosswordheaven.com/clues/barbers-obstruction
Stirrup site	crosswordheaven.com/clues/stirrup-site
It may be lent or bent	crosswordheaven.com/clues/it-may-be-lent-or-bent
Ring spot	crosswordheaven.com/clues/ring-spot
Place for a plug	crosswordheaven.com/clues/place-for-a-plug
Sympathetic attention	crosswordheaven.com/clues/sympathetic-attention
Musician's pride	crosswordheaven.com/clues/musicians-pride
It may be lent	crosswordheaven.com/clues/it-may-be-lent
Sensitivity	crosswordheaven.com/clues/sensitivity
Canal zone?	crosswordheaven.com/clues/canal-zone
Notice	crosswordheaven.com/clues/notice
Wax producer	crosswordheaven.com/clues/wax-producer
Place for jewelry	crosswordheaven.com/clues/place-for-jewelry
Place for a stud	crosswordheaven.com/clues/place-for-a-stud
Keen perception	crosswordheaven.com/clues/keen-perception
Order of corn	crosswordheaven.com/clues/order-of-corn
Something to lend or bend	crosswordheaven.com/clues/something-to-lend-or-bend
Wax collector	crosswordheaven.com/clues/wax-collector
Site of a helix and antihelix	crosswordheaven.com/clues/site-of-a-helix-and-antihelix
Cup handle	crosswordheaven.com/clues/cup-handle
Prominent dachshund feature	crosswordheaven.com/clues/prominent-dachshund-feature
Musical gift	crosswordheaven.com/clues/musical-gift
Musician's asset	crosswordheaven.com/clues/musicians-asset
Otologist's study	crosswordheaven.com/clues/otologists-study
A barber might nick it	crosswordheaven.com/clues/a-barber-might-nick-it
Drum site	crosswordheaven.com/clues/drum-site
Organ with a drum in it	crosswordheaven.com/clues/organ-with-a-drum-in-it
Mr. Potato Head part	crosswordheaven.com/clues/mr-potato-head-part
Lent part?	crosswordheaven.com/clues/lent-part
Canal locale	crosswordheaven.com/clues/canal-locale
Swab target	crosswordheaven.com/clues/swab-target
Musician's need	crosswordheaven.com/clues/musicians-need
Pencil holder, at times	crosswordheaven.com/clues/pencil-holder-at-times
Teacup handle	crosswordheaven.com/clues/teacup-handle
Word with drum or trumpet	crosswordheaven.com/clues/word-with-drum-or-trumpet
One sense, figuratively	crosswordheaven.com/clues/one-sense-figuratively
Kind of drum or trumpet	crosswordheaven.com/clues/kind-of-drum-or-trumpet
Barber's obstacle	crosswordheaven.com/clues/barbers-obstacle
Musician's gift	crosswordheaven.com/clues/musicians-gift
With 62-Down, animal identifier	crosswordheaven.com/clues/with-62-down-animal-identifier
Ring bearer, maybe	crosswordheaven.com/clues/ring-bearer-maybe
You can lend it or bend it	crosswordheaven.com/clues/you-can-lend-it-or-bend-it
A hoop may hang from it	crosswordheaven.com/clues/a-hoop-may-hang-from-it
Object near a temple	crosswordheaven.com/clues/object-near-a-temple
Cereal plant portion	crosswordheaven.com/clues/cereal-plant-portion
Serving of corn	crosswordheaven.com/clues/serving-of-corn
Stud site	crosswordheaven.com/clues/stud-site
Where to find a hammer or anvil	crosswordheaven.com/clues/where-to-find-a-hammer-or-anvil
Attention	crosswordheaven.com/clues/attention
It sticks out at the side	crosswordheaven.com/clues/it-sticks-out-at-the-side
Hammer site	crosswordheaven.com/clues/hammer-site
Drum locale	crosswordheaven.com/clues/drum-locale
Musical sense	crosswordheaven.com/clues/musical-sense
Musical perception	crosswordheaven.com/clues/musical-perception
Audience	crosswordheaven.com/clues/audience
Music appreciation	crosswordheaven.com/clues/music-appreciation
Musical sensitivity	crosswordheaven.com/clues/musical-sensitivity
Listen here	crosswordheaven.com/clues/listen-here
Spot for a headphone	crosswordheaven.com/clues/spot-for-a-headphone
Bean sprout?	crosswordheaven.com/clues/bean-sprout
Sound receiver	crosswordheaven.com/clues/sound-receiver
Ring locale	crosswordheaven.com/clues/ring-locale
Something to shuck	crosswordheaven.com/clues/something-to-shuck
Corn order	crosswordheaven.com/clues/corn-order
Musical aptitude	crosswordheaven.com/clues/musical-aptitude
Piercing site	crosswordheaven.com/clues/piercing-site
Stalk outgrowth	crosswordheaven.com/clues/stalk-outgrowth
Q-Tip target	crosswordheaven.com/clues/q-tip-target
Musical talent	crosswordheaven.com/clues/musical-talent
Pencil holder	crosswordheaven.com/clues/pencil-holder
A barber has to work around it	crosswordheaven.com/clues/a-barber-has-to-work-around-it
Shucker's unit	crosswordheaven.com/clues/shuckers-unit
Mr. Potato Head piece	crosswordheaven.com/clues/mr-potato-head-piece
    Word with candy or drops	crosswordheaven.com/clues/word-with-candy-or-drops
Labyrinth locale	crosswordheaven.com/clues/labyrinth-locale
"Lent" body part	crosswordheaven.com/clues/lent-body-part
Ring site	crosswordheaven.com/clues/ring-site
Lobe site	crosswordheaven.com/clues/lobe-site
___ canal	crosswordheaven.com/clues/___-canal
Hearing aid	crosswordheaven.com/clues/hearing-aid
Big feature of an elephant	crosswordheaven.com/clues/big-feature-of-an-elephant
It may be sympathetic	crosswordheaven.com/clues/it-may-be-sympathetic
Grin's boundary, so it's said	crosswordheaven.com/clues/grins-boundary-so-its-said
Conductor's need	crosswordheaven.com/clues/conductors-need
Listener	crosswordheaven.com/clues/listener
___ candy (pop music)	crosswordheaven.com/clues/___-candy-pop-music
Eustachian tube site	crosswordheaven.com/clues/eustachian-tube-site
It's often next to a phone	crosswordheaven.com/clues/its-often-next-to-a-phone
End point for an iPod cord	crosswordheaven.com/clues/end-point-for-an-ipod-cord
Big part of an elephant	crosswordheaven.com/clues/big-part-of-an-elephant
Pencil holder, sometimes	crosswordheaven.com/clues/pencil-holder-sometimes
Stud's place	crosswordheaven.com/clues/studs-place
Dog-___	crosswordheaven.com/clues/dog-___
Sound system component?	crosswordheaven.com/clues/sound-system-component
Place for a stirrup	crosswordheaven.com/clues/place-for-a-stirrup
You might play something by it	crosswordheaven.com/clues/you-might-play-something-by-it
Where a phone is held	crosswordheaven.com/clues/where-a-phone-is-held
It's needed to find the right key	crosswordheaven.com/clues/its-needed-to-find-the-right-key
Floppy rabbit feature	crosswordheaven.com/clues/floppy-rabbit-feature
What barotrauma affects	crosswordheaven.com/clues/what-barotrauma-affects
Prominent part of a dachshund	crosswordheaven.com/clues/prominent-part-of-a-dachshund
Audio receiver	crosswordheaven.com/clues/audio-receiver
Big elephant feature	crosswordheaven.com/clues/big-elephant-feature
Side flap	crosswordheaven.com/clues/side-flap
Prominent Chihuahua feature	crosswordheaven.com/clues/prominent-chihuahua-feature
___ candy (some pop tunes)	crosswordheaven.com/clues/___-candy-some-pop-tunes
Wave catcher?	crosswordheaven.com/clues/wave-catcher
Plug place	crosswordheaven.com/clues/plug-place
Pitching asset?	crosswordheaven.com/clues/pitching-asset
Ring setting	crosswordheaven.com/clues/ring-setting
Where the utricle is	crosswordheaven.com/clues/where-the-utricle-is
Iowa harvest unit	crosswordheaven.com/clues/iowa-harvest-unit
Inner ___	crosswordheaven.com/clues/inner-___
Audiologist's concern	crosswordheaven.com/clues/audiologists-concern
Where the antihelix is	crosswordheaven.com/clues/where-the-antihelix-is
Tin ___	crosswordheaven.com/clues/tin-___
Plug's place	crosswordheaven.com/clues/plugs-place
It may be cupped or cuffed	crosswordheaven.com/clues/it-may-be-cupped-or-cuffed
A hoop may be attached to it	crosswordheaven.com/clues/a-hoop-may-be-attached-to-it
Cauliflower ___	crosswordheaven.com/clues/cauliflower-___
Place for a ring	crosswordheaven.com/clues/place-for-a-ring
Place for a headphone	crosswordheaven.com/clues/place-for-a-headphone
Prominent donkey feature	crosswordheaven.com/clues/prominent-donkey-feature
It may be cocked	crosswordheaven.com/clues/it-may-be-cocked
The "E" in 64-Across	crosswordheaven.com/clues/the-e-in-64-across
Tarsus : foot :: incus : ___	crosswordheaven.com/clues/tarsus-foot-incus-___
It may pop on a plane	crosswordheaven.com/clues/it-may-pop-on-a-plane
What a barber has to trim around	crosswordheaven.com/clues/what-a-barber-has-to-trim-around
Obstacle for a barber	crosswordheaven.com/clues/obstacle-for-a-barber
Folded corner	crosswordheaven.com/clues/folded-corner
It might get a plug	crosswordheaven.com/clues/it-might-get-a-plug
It may be floppy or pointy	crosswordheaven.com/clues/it-may-be-floppy-or-pointy
What an aurilave cleans	crosswordheaven.com/clues/what-an-aurilave-cleans
Something that may be pricked	crosswordheaven.com/clues/something-that-may-be-pricked
There can be a ring in it or on it	crosswordheaven.com/clues/there-can-be-a-ring-in-it-or-on-it
Mr. Potato Head accessory	crosswordheaven.com/clues/mr-potato-head-accessory
Musical acuity	crosswordheaven.com/clues/musical-acuity
Carol Burnett tugged on hers	crosswordheaven.com/clues/carol-burnett-tugged-on-hers
Pencil holder, perhaps	crosswordheaven.com/clues/pencil-holder-perhaps
Anvil locale	crosswordheaven.com/clues/anvil-locale
Matador's trophy	crosswordheaven.com/clues/matadors-trophy
Corn unit	crosswordheaven.com/clues/corn-unit
Lobe's location	crosswordheaven.com/clues/lobes-location
Musicianship	crosswordheaven.com/clues/musicianship
Waxworks?	crosswordheaven.com/clues/waxworks
Anvil location	crosswordheaven.com/clues/anvil-location
Sound processor	crosswordheaven.com/clues/sound-processor
Van Gogh had one	crosswordheaven.com/clues/van-gogh-had-one
Musical taste	crosswordheaven.com/clues/musical-taste
Ringing site	crosswordheaven.com/clues/ringing-site
Mr. Potato Head attachment	crosswordheaven.com/clues/mr-potato-head-attachment
Swimmer's ___	crosswordheaven.com/clues/swimmers-___
Piece of corn	crosswordheaven.com/clues/piece-of-corn
Big grin terminus?	crosswordheaven.com/clues/big-grin-terminus
Hammer and anvil locale	crosswordheaven.com/clues/hammer-and-anvil-locale
Cornstalk offshoot	crosswordheaven.com/clues/cornstalk-offshoot
Musical discernment	crosswordheaven.com/clues/musical-discernment
Big grin delimiter?	crosswordheaven.com/clues/big-grin-delimiter
Lobe locale	crosswordheaven.com/clues/lobe-locale
Anvil's place	crosswordheaven.com/clues/anvils-place
Van Gogh's love offering	crosswordheaven.com/clues/van-goghs-love-offering
Target of many a piercing	crosswordheaven.com/clues/target-of-many-a-piercing
Place for a cow's 34-Down	crosswordheaven.com/clues/place-for-a-cows-34-down
Tin organ?	crosswordheaven.com/clues/tin-organ
Jug lug	crosswordheaven.com/clues/jug-lug
Ringing or ring site	crosswordheaven.com/clues/ringing-or-ring-site
Dumbo's "wing"	crosswordheaven.com/clues/dumbos-wing
Word before plug or horn	crosswordheaven.com/clues/word-before-plug-or-horn
Dumbo "wing"	crosswordheaven.com/clues/dumbo-wing
Attention, metaphorically	crosswordheaven.com/clues/attention-metaphorically
Organ with a drum inside	crosswordheaven.com/clues/organ-with-a-drum-inside
Spike	crosswordheaven.com/clues/spike
Where to find a hammer	crosswordheaven.com/clues/where-to-find-a-hammer
Lobe location	crosswordheaven.com/clues/lobe-location
Canal zone	crosswordheaven.com/clues/canal-zone
Talent for music	crosswordheaven.com/clues/talent-for-music
Phone attachment?	crosswordheaven.com/clues/phone-attachment
Hammer's location	crosswordheaven.com/clues/hammers-location
Either end of a wide grin	crosswordheaven.com/clues/either-end-of-a-wide-grin
Something to whisper into	crosswordheaven.com/clues/something-to-whisper-into
Equilibrium organ	crosswordheaven.com/clues/equilibrium-organ
Flair for music	crosswordheaven.com/clues/flair-for-music
Good listener?	crosswordheaven.com/clues/good-listener
Spot for a stud	crosswordheaven.com/clues/spot-for-a-stud
It may be ringed or ringing	crosswordheaven.com/clues/it-may-be-ringed-or-ringing
Pencil holder?	crosswordheaven.com/clues/pencil-holder
Plug setting?	crosswordheaven.com/clues/plug-setting
Cereal spike	crosswordheaven.com/clues/cereal-spike
Word before phone or ring	crosswordheaven.com/clues/word-before-phone-or-ring
Mike Tyson's 1997 mouthpiece?	crosswordheaven.com/clues/mike-tysons-1997-mouthpiece
Hearing need	crosswordheaven.com/clues/hearing-need
Cute as a bug's ___	crosswordheaven.com/clues/cute-as-a-bugs-___
Auricle	crosswordheaven.com/clues/auricle
Listening organ	crosswordheaven.com/clues/listening-organ
Auditory canal locale	crosswordheaven.com/clues/auditory-canal-locale
It's inside a husk	crosswordheaven.com/clues/its-inside-a-husk
Auditory nerve's locale	crosswordheaven.com/clues/auditory-nerves-locale
Lead-in to ring or drum	crosswordheaven.com/clues/lead-in-to-ring-or-drum
Hear here	crosswordheaven.com/clues/hear-here
It's cupped to catch a whisper	crosswordheaven.com/clues/its-cupped-to-catch-a-whisper
Drum location	crosswordheaven.com/clues/drum-location
Hammer and anvil site	crosswordheaven.com/clues/hammer-and-anvil-site
Organ with a canal	crosswordheaven.com/clues/organ-with-a-canal
Major elephant feature	crosswordheaven.com/clues/major-elephant-feature
It can be pierced or plugged	crosswordheaven.com/clues/it-can-be-pierced-or-plugged
Prominent part of Mickey's silhouette	crosswordheaven.com/clues/prominent-part-of-mickeys-silhouette
Ring bearer?	crosswordheaven.com/clues/ring-bearer
Hole in the head?	crosswordheaven.com/clues/hole-in-the-head
Head extension?	crosswordheaven.com/clues/head-extension
Otologist's concern	crosswordheaven.com/clues/otologists-concern
Corn spike	crosswordheaven.com/clues/corn-spike
Din detector	crosswordheaven.com/clues/din-detector
It can be pierced or pricked up	crosswordheaven.com/clues/it-can-be-pierced-or-pricked-up
It's near a temple	crosswordheaven.com/clues/its-near-a-temple
Mr. Spock's had a point	crosswordheaven.com/clues/mr-spocks-had-a-point
Plug place, perhaps	crosswordheaven.com/clues/plug-place-perhaps
Hearing aid?	crosswordheaven.com/clues/hearing-aid
Keen perception, musically	crosswordheaven.com/clues/keen-perception-musically
Word after dog or tin	crosswordheaven.com/clues/word-after-dog-or-tin
Stud setting	crosswordheaven.com/clues/stud-setting
Knack for music	crosswordheaven.com/clues/knack-for-music
Whisperer's target	crosswordheaven.com/clues/whisperers-target
Hoop site	crosswordheaven.com/clues/hoop-site
Organ with a hammer	crosswordheaven.com/clues/organ-with-a-hammer
Site of the smallest bone in the body	crosswordheaven.com/clues/site-of-the-smallest-bone-in-the-body
It may be cocked or cupped	crosswordheaven.com/clues/it-may-be-cocked-or-cupped
Human body part with vestigial muscles	crosswordheaven.com/clues/human-body-part-with-vestigial-muscles
Organ near a temple?	crosswordheaven.com/clues/organ-near-a-temple
Auditory organ	crosswordheaven.com/clues/auditory-organ
Jaime Sommers had a bionic one	crosswordheaven.com/clues/jaime-sommers-had-a-bionic-one
Pitch catcher	crosswordheaven.com/clues/pitch-catcher
Anvil's setting	crosswordheaven.com/clues/anvils-setting
Stirrup setting	crosswordheaven.com/clues/stirrup-setting
Body part to lend or bend	crosswordheaven.com/clues/body-part-to-lend-or-bend
Hammer and anvil setting	crosswordheaven.com/clues/hammer-and-anvil-setting
"In one ___ and out the other"	crosswordheaven.com/clues/in-one-___-and-out-the-other
Keep an ___ to the ground	crosswordheaven.com/clues/keep-an-___-to-the-ground
Piercing locale	crosswordheaven.com/clues/piercing-locale
Cochlea's locale	crosswordheaven.com/clues/cochleas-locale
Hoop holder, maybe	crosswordheaven.com/clues/hoop-holder-maybe
It can be lent or bent	crosswordheaven.com/clues/it-can-be-lent-or-bent
Cerumen's spot	crosswordheaven.com/clues/cerumens-spot
"You can't make a silk purse out of a sow's ___"	crosswordheaven.com/clues/you-cant-make-a-silk-purse-out-of-a-sows-___
Locale of a tiny stirrup	crosswordheaven.com/clues/locale-of-a-tiny-stirrup
Trophy for a matador	crosswordheaven.com/clues/trophy-for-a-matador
Pointy body part on a Vulcan	crosswordheaven.com/clues/pointy-body-part-on-a-vulcan
Stud's spot	crosswordheaven.com/clues/studs-spot
It can be swabbed	crosswordheaven.com/clues/it-can-be-swabbed
A cricket has one below each front leg joint	crosswordheaven.com/clues/a-cricket-has-one-below-each-front-leg-joint
Subject of otology	crosswordheaven.com/clues/subject-of-otology
Labyrinth location	crosswordheaven.com/clues/labyrinth-location
See 44-Across	crosswordheaven.com/clues/see-44-across
Holder of kernels	crosswordheaven.com/clues/holder-of-kernels
"___-Resistible" (Temptations album)	crosswordheaven.com/clues/___-resistible-temptations-album
Cochlear implant site	crosswordheaven.com/clues/cochlear-implant-site
Part of ENT	crosswordheaven.com/clues/part-of-ent
Acoustic organ	crosswordheaven.com/clues/acoustic-organ
It's found near a temple	crosswordheaven.com/clues/its-found-near-a-temple
Stirrup's spot	crosswordheaven.com/clues/stirrups-spot
Thing pulled when playing charades	crosswordheaven.com/clues/thing-pulled-when-playing-charades
Hammer home?	crosswordheaven.com/clues/hammer-home
Kernel holder	crosswordheaven.com/clues/kernel-holder
Ring bearer	crosswordheaven.com/clues/ring-bearer
Hoop holder	crosswordheaven.com/clues/hoop-holder
Crooner's asset	crosswordheaven.com/clues/crooners-asset
Site of semicircular canals	crosswordheaven.com/clues/site-of-semicircular-canals
Word with mark or muff	crosswordheaven.com/clues/word-with-mark-or-muff
Organ with a drum	crosswordheaven.com/clues/organ-with-a-drum
Organ for an otolaryngologist	crosswordheaven.com/clues/organ-for-an-otolaryngologist
Where you might see the last word of 20-, 32-, 41- and 53-Across	crosswordheaven.com/clues/where-you-might-see-the-last-word-of-20-32-41-and-53-across
Bit of corn	crosswordheaven.com/clues/bit-of-corn
Word with canal or drum	crosswordheaven.com/clues/word-with-canal-or-drum
Singer's asset	crosswordheaven.com/clues/singers-asset
Sound detector	crosswordheaven.com/clues/sound-detector
Organ with a lobe	crosswordheaven.com/clues/organ-with-a-lobe
Sound catcher	crosswordheaven.com/clues/sound-catcher
Cellist's gift	crosswordheaven.com/clues/cellists-gift
Jug handle	crosswordheaven.com/clues/jug-handle
Tympanic membrane site	crosswordheaven.com/clues/tympanic-membrane-site
Spike in a field	crosswordheaven.com/clues/spike-in-a-field
Word with muff or mark	crosswordheaven.com/clues/word-with-muff-or-mark
It may be pierced	crosswordheaven.com/clues/it-may-be-pierced
Spike in a grain field	crosswordheaven.com/clues/spike-in-a-grain-field
Spike, as of grain	crosswordheaven.com/clues/spike-as-of-grain
Oft-pierced body part	crosswordheaven.com/clues/oft-pierced-body-part
Corncrib item	crosswordheaven.com/clues/corncrib-item
Corn portion	crosswordheaven.com/clues/corn-portion
Stirrup spot	crosswordheaven.com/clues/stirrup-spot
Cobful of corn	crosswordheaven.com/clues/cobful-of-corn
__ candy (pleasing music)	crosswordheaven.com/clues/__-candy-pleasing-music
Anvil site	crosswordheaven.com/clues/anvil-site
Pitcher handle	crosswordheaven.com/clues/pitcher-handle
Tonal sense	crosswordheaven.com/clues/tonal-sense
11 Down portion	crosswordheaven.com/clues/11-down-portion
Lend an __ (listen)	crosswordheaven.com/clues/lend-an-__-listen
Portion of corn	crosswordheaven.com/clues/portion-of-corn
Pencil holder, often	crosswordheaven.com/clues/pencil-holder-often
Sense of pitch	crosswordheaven.com/clues/sense-of-pitch
Ossicles' site	crosswordheaven.com/clues/ossicles-site
Hearing organ	crosswordheaven.com/clues/hearing-organ
Temple neighbor	crosswordheaven.com/clues/temple-neighbor
Musical asset	crosswordheaven.com/clues/musical-asset
Glasses support	crosswordheaven.com/clues/glasses-support
Cob + kernels	crosswordheaven.com/clues/cob-kernels
''In one __ and out . . .''	crosswordheaven.com/clues/in-one-__-and-out
Corn purchase	crosswordheaven.com/clues/corn-purchase
Van Gogh's loss	crosswordheaven.com/clues/van-goghs-loss
Van Gogh had one in his later years	crosswordheaven.com/clues/van-gogh-had-one-in-his-later-years
Wax trapper	crosswordheaven.com/clues/wax-trapper
Stirrup's site	crosswordheaven.com/clues/stirrups-site
A friend may lend one	crosswordheaven.com/clues/a-friend-may-lend-one
Ability to discern good music	crosswordheaven.com/clues/ability-to-discern-good-music
Unit of corn	crosswordheaven.com/clues/unit-of-corn
Organ near the temple	crosswordheaven.com/clues/organ-near-the-temple
Something to lend a storyteller?	crosswordheaven.com/clues/something-to-lend-a-storyteller
Ability to distinguish pitch	crosswordheaven.com/clues/ability-to-distinguish-pitch
Wax container	crosswordheaven.com/clues/wax-container
Wheat spike	crosswordheaven.com/clues/wheat-spike
Ability to hit pitches?	crosswordheaven.com/clues/ability-to-hit-pitches
Word with ''drop'' or ''drum''	crosswordheaven.com/clues/word-with-drop-or-drum
''In one ___ and out the other''	crosswordheaven.com/clues/in-one-___-and-out-the-other
It may ring or have a ring	crosswordheaven.com/clues/it-may-ring-or-have-a-ring
Type of wax	crosswordheaven.com/clues/type-of-wax
Locale of a small stirrup	crosswordheaven.com/clues/locale-of-a-small-stirrup
Cerumen locale	crosswordheaven.com/clues/cerumen-locale
Aptitude for note-worthy creations?	crosswordheaven.com/clues/aptitude-for-note-worthy-creations
Toreador's trophy	crosswordheaven.com/clues/toreadors-trophy
Van Gogh had one later in life	crosswordheaven.com/clues/van-gogh-had-one-later-in-life
Cornfield unit	crosswordheaven.com/clues/cornfield-unit
Pencil parking place	crosswordheaven.com/clues/pencil-parking-place
Auditory apparatus	crosswordheaven.com/clues/auditory-apparatus
Auditory sensor	crosswordheaven.com/clues/auditory-sensor
Wax manufacturer	crosswordheaven.com/clues/wax-manufacturer
Traditional piercing site	crosswordheaven.com/clues/traditional-piercing-site
Drop target, sometimes	crosswordheaven.com/clues/drop-target-sometimes
Affinity for music	crosswordheaven.com/clues/affinity-for-music
Anvil and stirrup site	crosswordheaven.com/clues/anvil-and-stirrup-site
Where to find a cochlea	crosswordheaven.com/clues/where-to-find-a-cochlea
It's used to find the right key	crosswordheaven.com/clues/its-used-to-find-the-right-key
Anvil setting	crosswordheaven.com/clues/anvil-setting
It's used when looking for the right key	crosswordheaven.com/clues/its-used-when-looking-for-the-right-key
Where the incus bone is	crosswordheaven.com/clues/where-the-incus-bone-is
Thermometer insertion point, perhaps	crosswordheaven.com/clues/thermometer-insertion-point-perhaps
Otic organ	crosswordheaven.com/clues/otic-organ
Word with "mark" or "splitting"	crosswordheaven.com/clues/word-with-mark-or-splitting
You may lend it or bend it	crosswordheaven.com/clues/you-may-lend-it-or-bend-it
Organ of equilibrium	crosswordheaven.com/clues/organ-of-equilibrium
It has its own drum	crosswordheaven.com/clues/it-has-its-own-drum
It's part of a head	crosswordheaven.com/clues/its-part-of-a-head
Word with drops or canal	crosswordheaven.com/clues/word-with-drops-or-canal
A hole in the head?	crosswordheaven.com/clues/a-hole-in-the-head
Word with wax or drops	crosswordheaven.com/clues/word-with-wax-or-drops
Place for a small drum?	crosswordheaven.com/clues/place-for-a-small-drum
Equilibrium provider	crosswordheaven.com/clues/equilibrium-provider
One of a boxed set?	crosswordheaven.com/clues/one-of-a-boxed-set
Something to bend on a human	crosswordheaven.com/clues/something-to-bend-on-a-human
It's laid back on an angry horse	crosswordheaven.com/clues/its-laid-back-on-an-angry-horse
It may be pulled	crosswordheaven.com/clues/it-may-be-pulled
Word with muff or flap	crosswordheaven.com/clues/word-with-muff-or-flap
Vulcan feature	crosswordheaven.com/clues/vulcan-feature
Hammer's home	crosswordheaven.com/clues/hammers-home
It helps keep one balanced	crosswordheaven.com/clues/it-helps-keep-one-balanced
Musician's boon	crosswordheaven.com/clues/musicians-boon
Musical acumen	crosswordheaven.com/clues/musical-acumen
Listen here!	crosswordheaven.com/clues/listen-here
Trophy handle	crosswordheaven.com/clues/trophy-handle
Word with "flap" or "drum"	crosswordheaven.com/clues/word-with-flap-or-drum
Where the smallest bones in the body are located	crosswordheaven.com/clues/where-the-smallest-bones-in-the-body-are-located
Shucked item	crosswordheaven.com/clues/shucked-item
Stirrup location	crosswordheaven.com/clues/stirrup-location
Distinctive Vulcan feature	crosswordheaven.com/clues/distinctive-vulcan-feature
Topic of corn-versation?	crosswordheaven.com/clues/topic-of-corn-versation
Thing to bend or lend	crosswordheaven.com/clues/thing-to-bend-or-lend
Elephant's floppy feature	crosswordheaven.com/clues/elephants-floppy-feature
Big beagle feature	crosswordheaven.com/clues/big-beagle-feature
Spot for a hammer in the head	crosswordheaven.com/clues/spot-for-a-hammer-in-the-head
Musical aptitude, of a sort	crosswordheaven.com/clues/musical-aptitude-of-a-sort
Play by ___ (without sheet music)	crosswordheaven.com/clues/play-by-___-without-sheet-music
Place to put a bud	crosswordheaven.com/clues/place-to-put-a-bud
Mr. Potato Head stick-on	crosswordheaven.com/clues/mr-potato-head-stick-on
Musical knack	crosswordheaven.com/clues/musical-knack
Canal setting	crosswordheaven.com/clues/canal-setting
Sideburn neighbor	crosswordheaven.com/clues/sideburn-neighbor
Ability to appreciate music	crosswordheaven.com/clues/ability-to-appreciate-music
Van Gogh's missing piece?	crosswordheaven.com/clues/van-goghs-missing-piece
Where you'll find a stirrup	crosswordheaven.com/clues/where-youll-find-a-stirrup
Traditionalist's piercing site	crosswordheaven.com/clues/traditionalists-piercing-site
Eustachian tube locale	crosswordheaven.com/clues/eustachian-tube-locale
You might play something by this	crosswordheaven.com/clues/you-might-play-something-by-this
It may be plugged or pierced	crosswordheaven.com/clues/it-may-be-plugged-or-pierced
Elephant's-___ (plant)	crosswordheaven.com/clues/elephants-___-plant
A pencil may be parked behind here	crosswordheaven.com/clues/a-pencil-may-be-parked-behind-here
Pitcher feature	crosswordheaven.com/clues/pitcher-feature
Musical skill	crosswordheaven.com/clues/musical-skill
Song played at the school dance in "Back to the Future"	crosswordheaven.com/clues/song-played-at-the-school-dance-in-back-to-the-future
Field unit	crosswordheaven.com/clues/field-unit
Improviser's asset	crosswordheaven.com/clues/improvisers-asset
Ring holder ... or receiver?	crosswordheaven.com/clues/ring-holder-or-receiver
Drum holder	crosswordheaven.com/clues/drum-holder
Otologist's focus	crosswordheaven.com/clues/otologists-focus
Word before canal or candy	crosswordheaven.com/clues/word-before-canal-or-candy
Sense of sound	crosswordheaven.com/clues/sense-of-sound
Bud's place	crosswordheaven.com/clues/buds-place
Word with "drop" or "drum"	crosswordheaven.com/clues/word-with-drop-or-drum
Where 76-Across may be worn	crosswordheaven.com/clues/where-76-across-may-be-worn
Elephant's ___ (plant)	crosswordheaven.com/clues/elephants-___-plant
Makeshift pencil holder	crosswordheaven.com/clues/makeshift-pencil-holder
__ candy	crosswordheaven.com/clues/__-candy
Pierced organ	crosswordheaven.com/clues/pierced-organ
Tyson's infamous biting target	crosswordheaven.com/clues/tysons-infamous-biting-target
Poor listener's in-and-out organ	crosswordheaven.com/clues/poor-listeners-in-and-out-organ
Tin ___ (lack of musical sense)	crosswordheaven.com/clues/tin-___-lack-of-musical-sense
Bud holder	crosswordheaven.com/clues/bud-holder
"... silk purse out of a sow%C2%92s ___"	crosswordheaven.com/clues/silk-purse-out-of-a-sowc292s-___
Swab's target	crosswordheaven.com/clues/swabs-target
"... silk purse out of a sows ___"	crosswordheaven.com/clues/silk-purse-out-of-a-sows-___
It's bent by a bore	crosswordheaven.com/clues/its-bent-by-a-bore
Ring or phone lead-in	crosswordheaven.com/clues/ring-or-phone-lead-in
Wide grin terminus	crosswordheaven.com/clues/wide-grin-terminus
Van Gogh wound up with one	crosswordheaven.com/clues/van-gogh-wound-up-with-one
Hammer-and-anvil site	crosswordheaven.com/clues/hammer-and-anvil-site
Semicircular-canal site	crosswordheaven.com/clues/semicircular-canal-site
"In one ___ and out ..."	crosswordheaven.com/clues/in-one-___-and-out
___ candy (pleasing music)	crosswordheaven.com/clues/___-candy-pleasing-music
Lend an ___ (listen)	crosswordheaven.com/clues/lend-an-___-listen
Corny bit?	crosswordheaven.com/clues/corny-bit
___ candy	crosswordheaven.com/clues/___-candy
Bud holder?	crosswordheaven.com/clues/bud-holder
Place to whisper sweet nothings	crosswordheaven.com/clues/place-to-whisper-sweet-nothings
ENT part	crosswordheaven.com/clues/ent-part
See 11-Down	crosswordheaven.com/clues/see-11-down
Pinna's place	crosswordheaven.com/clues/pinnas-place
Cochlea site	crosswordheaven.com/clues/cochlea-site
Word before "buds"	crosswordheaven.com/clues/word-before-buds
Tyson nugget?	crosswordheaven.com/clues/tyson-nugget
Where to hold a telephone receiver	crosswordheaven.com/clues/where-to-hold-a-telephone-receiver
Van Gogh lost one	crosswordheaven.com/clues/van-gogh-lost-one
Receptor	crosswordheaven.com/clues/receptor
Listening device?	crosswordheaven.com/clues/listening-device
Audition	crosswordheaven.com/clues/audition
Head part	crosswordheaven.com/clues/head-part
Lend an ______	crosswordheaven.com/clues/lend-an-______
Corn cob	crosswordheaven.com/clues/corn-cob
Musicians gift	crosswordheaven.com/clues/musicians-gift
Part of a corn plant	crosswordheaven.com/clues/part-of-a-corn-plant
Musical cognizance	crosswordheaven.com/clues/musical-cognizance
A musical talent	crosswordheaven.com/clues/a-musical-talent
Sensor	crosswordheaven.com/clues/sensor
Corn container?	crosswordheaven.com/clues/corn-container
____ Falls, Ontario	crosswordheaven.com/clues/____-falls-ontario
Musical sound receiver	crosswordheaven.com/clues/musical-sound-receiver
It can ache	crosswordheaven.com/clues/it-can-ache
Bionic part of the Bionic Woman	crosswordheaven.com/clues/bionic-part-of-the-bionic-woman
Dumbo's wing	crosswordheaven.com/clues/dumbos-wing
Acoustic organ?	crosswordheaven.com/clues/acoustic-organ
It's beside a sideburn	crosswordheaven.com/clues/its-beside-a-sideburn
Pencil-parking place	crosswordheaven.com/clues/pencil-parking-place
Ring location?	crosswordheaven.com/clues/ring-location
Aural organ	crosswordheaven.com/clues/aural-organ
Pointy Spock feature	crosswordheaven.com/clues/pointy-spock-feature
It contains a human drum	crosswordheaven.com/clues/it-contains-a-human-drum
Hoop spot	crosswordheaven.com/clues/hoop-spot
Jug part	crosswordheaven.com/clues/jug-part
Shape of orecchietta pasta	crosswordheaven.com/clues/shape-of-orecchietta-pasta
Lend an ___	crosswordheaven.com/clues/lend-an-___
Tuner's talent	crosswordheaven.com/clues/tuners-talent
Site of the body's smallest bones	crosswordheaven.com/clues/site-of-the-bodys-smallest-bones
51-Across target	crosswordheaven.com/clues/51-across-target
Van Gogh: ___ today, gone tomorrow?	crosswordheaven.com/clues/van-gogh-___-today-gone-tomorrow
Place to put a plug	crosswordheaven.com/clues/place-to-put-a-plug
Acoustic instrument	crosswordheaven.com/clues/acoustic-instrument
Corn measure	crosswordheaven.com/clues/corn-measure
Plant's grain-bearing part	crosswordheaven.com/clues/plants-grain-bearing-part
"In My ___" (Toad the Wet Sprocket song)	crosswordheaven.com/clues/in-my-___-toad-the-wet-sprocket-song
Labyrinth setting	crosswordheaven.com/clues/labyrinth-setting
Word with phone or ring	crosswordheaven.com/clues/word-with-phone-or-ring
Sense organ	crosswordheaven.com/clues/sense-organ
Sense organ	crosswordheaven.com/clues/sense-organ
Lobe spot	crosswordheaven.com/clues/lobe-spot
Lobed organ	crosswordheaven.com/clues/lobed-organ
Corn holder	crosswordheaven.com/clues/corn-holder
Cochlea setting	crosswordheaven.com/clues/cochlea-setting
Lobe setting	crosswordheaven.com/clues/lobe-setting
Corn helping	crosswordheaven.com/clues/corn-helping
Musical appreciation	crosswordheaven.com/clues/musical-appreciation
Elephant feature	crosswordheaven.com/clues/elephant-feature
Canal spot	crosswordheaven.com/clues/canal-spot
Sound receptor	crosswordheaven.com/clues/sound-receptor
Anvil's site	crosswordheaven.com/clues/anvils-site
Otologist's subject	crosswordheaven.com/clues/otologists-subject
One part of ENT ...	crosswordheaven.com/clues/one-part-of-ent
Audiology subject	crosswordheaven.com/clues/audiology-subject
Cauliflower, maybe	crosswordheaven.com/clues/cauliflower-maybe
Good hearing	crosswordheaven.com/clues/good-hearing
Dumbo's 'wing'	crosswordheaven.com/clues/dumbos-wing
Otology subject	crosswordheaven.com/clues/otology-subject
Stirrup's locale	crosswordheaven.com/clues/stirrups-locale
Ring  setting	crosswordheaven.com/clues/ring-setting
Lobe  setting	crosswordheaven.com/clues/lobe-setting
Lobed thing	crosswordheaven.com/clues/lobed-thing
Play it by ___	crosswordheaven.com/clues/play-it-by-___
Piercing target	crosswordheaven.com/clues/piercing-target
Audio receiver?	crosswordheaven.com/clues/audio-receiver
Wax collector?	crosswordheaven.com/clues/wax-collector
With 19 Down, otalgia	crosswordheaven.com/clues/with-19-down-otalgia
Musical aptitude, as it were	crosswordheaven.com/clues/musical-aptitude-as-it-were
Maestro's gift	crosswordheaven.com/clues/maestros-gift
You may eavesdrop with it	crosswordheaven.com/clues/you-may-eavesdrop-with-it
With 76 Down, cerumen	crosswordheaven.com/clues/with-76-down-cerumen
"... silk purse out of a sow's ___"	crosswordheaven.com/clues/silk-purse-out-of-a-sows-___
Aural aptitude	crosswordheaven.com/clues/aural-aptitude
Where the smallest human bone is	crosswordheaven.com/clues/where-the-smallest-human-bone-is
Place for some plugs	crosswordheaven.com/clues/place-for-some-plugs
Hammer home	crosswordheaven.com/clues/hammer-home
Hearing device	crosswordheaven.com/clues/hearing-device
Floppy feature of a basset hound	crosswordheaven.com/clues/floppy-feature-of-a-basset-hound
Gift for music	crosswordheaven.com/clues/gift-for-music
Big part of a hare	crosswordheaven.com/clues/big-part-of-a-hare
A listener's need	crosswordheaven.com/clues/a-listeners-need
Ring site?	crosswordheaven.com/clues/ring-site
Barbecue side dish unit	crosswordheaven.com/clues/barbecue-side-dish-unit
Van Gogh pun: ___ today, gone tomorrow?	crosswordheaven.com/clues/van-gogh-pun-___-today-gone-tomorrow
36 Across portion	crosswordheaven.com/clues/36-across-portion
Bud's beginning	crosswordheaven.com/clues/buds-beginning
Organ of hearing	crosswordheaven.com/clues/organ-of-hearing
Perfect pitch organ	crosswordheaven.com/clues/perfect-pitch-organ
Organ that's sensitive to vibrations	crosswordheaven.com/clues/organ-thats-sensitive-to-vibrations
Hairstylist's obstacle?	crosswordheaven.com/clues/hairstylists-obstacle
Swimmer's ___ (medical ailment)	crosswordheaven.com/clues/swimmers-___-medical-ailment
Knack for dialogue	crosswordheaven.com/clues/knack-for-dialogue
Musician's gift?	crosswordheaven.com/clues/musicians-gift
Put an H in front of it to make something you can do with it	crosswordheaven.com/clues/put-an-h-in-front-of-it-to-make-something-you-can-do-with-it
Where singing is heard?	crosswordheaven.com/clues/where-singing-is-heard
Mike Tyson's in-fight snack	crosswordheaven.com/clues/mike-tysons-in-fight-snack
Spot for a ring	crosswordheaven.com/clues/spot-for-a-ring
Beagle's drooper	crosswordheaven.com/clues/beagles-drooper
What a headphone goes over	crosswordheaven.com/clues/what-a-headphone-goes-over
Part of E.N.T.	crosswordheaven.com/clues/part-of-ent
Big grin stopping point?	crosswordheaven.com/clues/big-grin-stopping-point
Listening post	crosswordheaven.com/clues/listening-post
Where to find the Cochlea	crosswordheaven.com/clues/where-to-find-the-cochlea
What a barber must cut around	crosswordheaven.com/clues/what-a-barber-must-cut-around
It helps hold glasses	crosswordheaven.com/clues/it-helps-hold-glasses
Hearing thing	crosswordheaven.com/clues/hearing-thing
Prominent part of a basset hound	crosswordheaven.com/clues/prominent-part-of-a-basset-hound
Corn amount	crosswordheaven.com/clues/corn-amount
Noise detector	crosswordheaven.com/clues/noise-detector
Hoop siite	crosswordheaven.com/clues/hoop-siite
George has a bad one in "It's A Wonderful Life"	crosswordheaven.com/clues/george-has-a-bad-one-in-its-a-wonderful-life
Teacup part	crosswordheaven.com/clues/teacup-part
Kind of plug or bud	crosswordheaven.com/clues/kind-of-plug-or-bud
Knack for notes	crosswordheaven.com/clues/knack-for-notes
See 32 Down	crosswordheaven.com/clues/see-32-down
Discernment of a sort	crosswordheaven.com/clues/discernment-of-a-sort
Word with "muff" or "mark"	crosswordheaven.com/clues/word-with-muff-or-mark
Organ of balance	crosswordheaven.com/clues/organ-of-balance
One may play something by this	crosswordheaven.com/clues/one-may-play-something-by-this
Musicians gift?	crosswordheaven.com/clues/musicians-gift
Auditory sense	crosswordheaven.com/clues/auditory-sense
Cup handle	http://www.crosswordgiant.com/crossword-clue/60617/Cup-handle
Listener	http://www.crosswordgiant.com/crossword-clue/157673/Listener
Corn spike	http://www.crosswordgiant.com/crossword-clue/220453/Corn-spike
Listening device	http://www.crosswordgiant.com/crossword-clue/4193/Listening-device
Corn unit	http://www.crosswordgiant.com/crossword-clue/175459/Corn-unit
Musical ability	http://www.crosswordgiant.com/crossword-clue/143498/Musical-ability
Corn serving	http://www.crosswordgiant.com/crossword-clue/4120/Corn-serving
Musical gift	http://www.crosswordgiant.com/crossword-clue/71054/Musical-gift
Attention	http://www.crosswordgiant.com/crossword-clue/139808/Attention
Receptor	http://www.crosswordgiant.com/crossword-clue/389848/Receptor
Canal site	http://www.crosswordgiant.com/crossword-clue/6803/Canal-site
Jug handle	http://www.crosswordgiant.com/crossword-clue/182615/Jug-handle
Musical aptitude	http://www.crosswordgiant.com/crossword-clue/235905/Musical-aptitude
Musical talent	http://www.crosswordgiant.com/crossword-clue/223209/Musical-talent
Ring setting	http://www.crosswordgiant.com/crossword-clue/223754/Ring-setting
Corn portion	http://www.crosswordgiant.com/crossword-clue/381622/Corn-portion
Place for a plug	http://www.crosswordgiant.com/crossword-clue/28200/Place-for-a-plug
Musical sense	http://www.crosswordgiant.com/crossword-clue/163385/Musical-sense
Lobed organ	http://www.crosswordgiant.com/crossword-clue/232926/Lobed-organ
Pitcher part	http://www.crosswordgiant.com/crossword-clue/14597/Pitcher-part
Musician's asset	http://www.crosswordgiant.com/crossword-clue/67146/Musicians-asset
Organ of hearing	http://www.crosswordgiant.com/crossword-clue/975333/Organ-of-hearing
Cochlea setting	http://www.crosswordgiant.com/crossword-clue/299059/Cochlea-setting
Plug's place	http://www.crosswordgiant.com/crossword-clue/40770/Plugs-place
Canal zone?	http://www.crosswordgiant.com/crossword-clue/46224/Canal-zone
Music appreciation	http://www.crosswordgiant.com/crossword-clue/193736/Music-appreciation
Acoustic organ	http://www.crosswordgiant.com/crossword-clue/225169/Acoustic-organ
Aural organ	http://www.crosswordgiant.com/crossword-clue/333641/Aural-organ
Hearing organ	http://www.crosswordgiant.com/crossword-clue/579158/Hearing-organ
Audience	http://www.crosswordgiant.com/crossword-clue/5481/Audience
Sympathetic attention	http://www.crosswordgiant.com/crossword-clue/34916/Sympathetic-attention
Canal locale	http://www.crosswordgiant.com/crossword-clue/154322/Canal-locale
Audio receiver	http://www.crosswordgiant.com/crossword-clue/239342/Audio-receiver
Sense organ	http://www.crosswordgiant.com/crossword-clue/985725/Sense-organ
Ring site	http://www.crosswordgiant.com/crossword-clue/3052/Ring-site
Order of corn	http://www.crosswordgiant.com/crossword-clue/53844/Order-of-corn
Cup handle	http://www.crosswordgiant.com/crossword-clue/60617/Cup-handle
Place for a stud	http://www.crosswordgiant.com/crossword-clue/65846/Place-for-a-stud
Musician's gift	http://www.crosswordgiant.com/crossword-clue/122885/Musicians-gift
Place for a ring	http://www.crosswordgiant.com/crossword-clue/173318/Place-for-a-ring
Musical perception	http://www.crosswordgiant.com/crossword-clue/222630/Musical-perception
Canal setting	http://www.crosswordgiant.com/crossword-clue/224564/Canal-setting
Piercing site	http://www.crosswordgiant.com/crossword-clue/231430/Piercing-site
Hearing aid	http://www.crosswordgiant.com/crossword-clue/291246/Hearing-aid
Mr. Potato Head piece	http://www.crosswordgiant.com/crossword-clue/292794/Mr.-Potato-Head-piece
Knack for music	http://www.crosswordgiant.com/crossword-clue/345093/Knack-for-music
Toreador's trophy	http://www.crosswordgiant.com/crossword-clue/362913/Toreadors-trophy
Lobe spot	http://www.crosswordgiant.com/crossword-clue/374497/Lobe-spot
Organ with a drum	http://www.crosswordgiant.com/crossword-clue/465506/Organ-with-a-drum
Audio receiver?	http://www.crosswordgiant.com/crossword-clue/467375/Audio-receiver
Listening organ	http://www.crosswordgiant.com/crossword-clue/492463/Listening-organ
Drum site	http://www.crosswordgiant.com/crossword-clue/496434/Drum-site
Portion of corn	http://www.crosswordgiant.com/crossword-clue/557893/Portion-of-corn
"In one ___ and out the other"	http://www.crosswordgiant.com/crossword-clue/714214/In-one-___-and-out-the-other
Stirrup site	http://www.crosswordgiant.com/crossword-clue/34306/Stirrup-site
It may be lent or bent	http://www.crosswordgiant.com/crossword-clue/43048/It-may-be-lent-or-bent
Hearing aid?	http://www.crosswordgiant.com/crossword-clue/83604/Hearing-aid
Teacup handle	http://www.crosswordgiant.com/crossword-clue/108418/Teacup-handle
Pencil holder, at times	http://www.crosswordgiant.com/crossword-clue/127433/Pencil-holder-at-times
Ring bearer, maybe	http://www.crosswordgiant.com/crossword-clue/143939/Ring-bearer-maybe
Musical sensitivity	http://www.crosswordgiant.com/crossword-clue/182214/Musical-sensitivity
Van Gogh had one later in life	http://www.crosswordgiant.com/crossword-clue/239373/Van-Gogh-had-one-later-in-life
A barber has to work around it	http://www.crosswordgiant.com/crossword-clue/291248/A-barber-has-to-work-around-it
Organ of equilibrium	http://www.crosswordgiant.com/crossword-clue/315770/Organ-of-equilibrium
Anvil setting	http://www.crosswordgiant.com/crossword-clue/325386/Anvil-setting
Stirrup setting	http://www.crosswordgiant.com/crossword-clue/399350/Stirrup-setting
Head of corn	http://www.crosswordgiant.com/crossword-clue/968023/Head-of-corn
Wax producer	http://www.crosswordgiant.com/crossword-clue/46395/Wax-producer
Serving of corn	http://www.crosswordgiant.com/crossword-clue/154688/Serving-of-corn
Hammer site	http://www.crosswordgiant.com/crossword-clue/170123/Hammer-site
Something to bend on a human	http://www.crosswordgiant.com/crossword-clue/186269/Something-to-bend-on-a-human
Listen here	http://www.crosswordgiant.com/crossword-clue/192162/Listen-here
Stirrup's site	http://www.crosswordgiant.com/crossword-clue/197112/Stirrups-site
Hammer and anvil site	http://www.crosswordgiant.com/crossword-clue/213215/Hammer-and-anvil-site
Anvil locale	http://www.crosswordgiant.com/crossword-clue/218974/Anvil-locale
Kernel holder	http://www.crosswordgiant.com/crossword-clue/234424/Kernel-holder
Van Gogh had one in his later years	http://www.crosswordgiant.com/crossword-clue/252314/Van-Gogh-had-one-in-his-later-years
Affinity for music	http://www.crosswordgiant.com/crossword-clue/269544/Affinity-for-music
Mr. Potato Head stick-on	http://www.crosswordgiant.com/crossword-clue/311632/Mr.-Potato-Head-stick-on
Elephant feature	http://www.crosswordgiant.com/crossword-clue/326146/Elephant-feature
Anvil's place	http://www.crosswordgiant.com/crossword-clue/326862/Anvils-place
Shucker's unit	http://www.crosswordgiant.com/crossword-clue/342790/Shuckers-unit
Auditory apparatus	http://www.crosswordgiant.com/crossword-clue/344618/Auditory-apparatus
Lobe locale	http://www.crosswordgiant.com/crossword-clue/404496/Lobe-locale
Auricle	http://www.crosswordgiant.com/crossword-clue/514750/Auricle
Musical discernment	http://www.crosswordgiant.com/crossword-clue/693527/Musical-discernment
Fruiting head of corn	http://www.crosswordgiant.com/crossword-clue/989630/Fruiting-head-of-corn
Stud site	http://www.crosswordgiant.com/crossword-clue/28838/Stud-site
Something to lend or bend	http://www.crosswordgiant.com/crossword-clue/51548/Something-to-lend-or-bend
Ring locale	http://www.crosswordgiant.com/crossword-clue/52867/Ring-locale
Ring bearer	http://www.crosswordgiant.com/crossword-clue/80678/Ring-bearer
Barber's obstacle	http://www.crosswordgiant.com/crossword-clue/83928/Barbers-obstacle
Cochlea site	http://www.crosswordgiant.com/crossword-clue/101567/Cochlea-site
Musical knack	http://www.crosswordgiant.com/crossword-clue/102786/Musical-knack
Musician's need	http://www.crosswordgiant.com/crossword-clue/111665/Musicians-need
A hoop may hang from it	http://www.crosswordgiant.com/crossword-clue/131178/A-hoop-may-hang-from-it
Lend it or bend it	http://www.crosswordgiant.com/crossword-clue/132394/Lend-it-or-bend-it
Mr. Potato Head accessory	http://www.crosswordgiant.com/crossword-clue/152241/Mr.-Potato-Head-accessory
Stirrup location	http://www.crosswordgiant.com/crossword-clue/160189/Stirrup-location
Ability to distinguish pitch	http://www.crosswordgiant.com/crossword-clue/205353/Ability-to-distinguish-pitch
Sound receiver	http://www.crosswordgiant.com/crossword-clue/218431/Sound-receiver
Jug part	http://www.crosswordgiant.com/crossword-clue/236969/Jug-part
Lobe setting	http://www.crosswordgiant.com/crossword-clue/238035/Lobe-setting
Q-Tip target	http://www.crosswordgiant.com/crossword-clue/240650/Q-Tip-target
Auditory organ	http://www.crosswordgiant.com/crossword-clue/281694/Auditory-organ
Lobe site	http://www.crosswordgiant.com/crossword-clue/313106/Lobe-site
Word before drop or flap	http://www.crosswordgiant.com/crossword-clue/319034/Word-before-drop-or-flap
Labyrinth locale	http://www.crosswordgiant.com/crossword-clue/327081/Labyrinth-locale
Phone attachment?	http://www.crosswordgiant.com/crossword-clue/336804/Phone-attachment
Organ near the temple	http://www.crosswordgiant.com/crossword-clue/363622/Organ-near-the-temple
Tympanic membrane site	http://www.crosswordgiant.com/crossword-clue/378546/Tympanic-membrane-site
Musical appreciation	http://www.crosswordgiant.com/crossword-clue/398332/Musical-appreciation
Drum location	http://www.crosswordgiant.com/crossword-clue/402999/Drum-location
Hoop site	http://www.crosswordgiant.com/crossword-clue/410154/Hoop-site
Corn plant part	http://www.crosswordgiant.com/crossword-clue/425181/Corn-plant-part
Labyrinth location	http://www.crosswordgiant.com/crossword-clue/438220/Labyrinth-location
Van Gogh's loss	http://www.crosswordgiant.com/crossword-clue/447144/Van-Goghs-loss
Sound processor	http://www.crosswordgiant.com/crossword-clue/453715/Sound-processor
A friend may lend one	http://www.crosswordgiant.com/crossword-clue/523839/A-friend-may-lend-one
You might play something by it	http://www.crosswordgiant.com/crossword-clue/528639/You-might-play-something-by-it
Ability to hit pitches?	http://www.crosswordgiant.com/crossword-clue/545348/Ability-to-hit-pitches
Floppy rabbit feature	http://www.crosswordgiant.com/crossword-clue/565422/Floppy-rabbit-feature
Bit of corn	http://www.crosswordgiant.com/crossword-clue/604236/Bit-of-corn
Musical asset	http://www.crosswordgiant.com/crossword-clue/635968/Musical-asset
Unit of corn	http://www.crosswordgiant.com/crossword-clue/676091/Unit-of-corn
Ability to discern good music	http://www.crosswordgiant.com/crossword-clue/739152/Ability-to-discern-good-music
Site of the smallest bone in the body	http://www.crosswordgiant.com/crossword-clue/785473/Site-of-the-smallest-bone-in-the-body
Big beagle feature	http://www.crosswordgiant.com/crossword-clue/817639/Big-beagle-feature
Sense of sound	http://www.crosswordgiant.com/crossword-clue/902135/Sense-of-sound
"... silk purse out of a sow's ___"	http://www.crosswordgiant.com/crossword-clue/910035/...-silk-purse-out-of-a-sows-___
Barber's obstruction	http://www.crosswordgiant.com/crossword-clue/8531/Barbers-obstruction
It may be pulled in charades	http://www.crosswordgiant.com/crossword-clue/11904/It-may-be-pulled-in-charades
See 11-Down	http://www.crosswordgiant.com/crossword-clue/23299/See-11-Down
Place for jewelry	http://www.crosswordgiant.com/crossword-clue/46881/Place-for-jewelry
Wax collector	http://www.crosswordgiant.com/crossword-clue/63582/Wax-collector
Prominent dachshund feature	http://www.crosswordgiant.com/crossword-clue/70900/Prominent-dachshund-feature
Good listener?	http://www.crosswordgiant.com/crossword-clue/78223/Good-listener
Corn holder	http://www.crosswordgiant.com/crossword-clue/81633/Corn-holder
Canal location	http://www.crosswordgiant.com/crossword-clue/84253/Canal-location
Anvil location	http://www.crosswordgiant.com/crossword-clue/85662/Anvil-location
Sound sense	http://www.crosswordgiant.com/crossword-clue/116972/Sound-sense
A tuner's asset	http://www.crosswordgiant.com/crossword-clue/127873/A-tuners-asset
Bud holder	http://www.crosswordgiant.com/crossword-clue/138359/Bud-holder
Stud setting	http://www.crosswordgiant.com/crossword-clue/169501/Stud-setting
It's bent by a bore	http://www.crosswordgiant.com/crossword-clue/170371/Its-bent-by-a-bore
You can lend it or bend it	http://www.crosswordgiant.com/crossword-clue/173085/You-can-lend-it-or-bend-it
Corn cob	http://www.crosswordgiant.com/crossword-clue/173196/Corn-cob
Wax container	http://www.crosswordgiant.com/crossword-clue/179762/Wax-container
Pitch catcher	http://www.crosswordgiant.com/crossword-clue/191467/Pitch-catcher
Matador's trophy	http://www.crosswordgiant.com/crossword-clue/192234/Matadors-trophy
Corny bit?	http://www.crosswordgiant.com/crossword-clue/193467/Corny-bit
Listen here!	http://www.crosswordgiant.com/crossword-clue/199329/Listen-here
Labyrinth setting	http://www.crosswordgiant.com/crossword-clue/207664/Labyrinth-setting
Trophy part	http://www.crosswordgiant.com/crossword-clue/223779/Trophy-part
Pencil parking place	http://www.crosswordgiant.com/crossword-clue/225372/Pencil-parking-place
Wax trapper	http://www.crosswordgiant.com/crossword-clue/246086/Wax-trapper
Wax manufacturer	http://www.crosswordgiant.com/crossword-clue/256123/Wax-manufacturer
Pencil holder	http://www.crosswordgiant.com/crossword-clue/271374/Pencil-holder
Lobe  setting	http://www.crosswordgiant.com/crossword-clue/273515/Lobe-setting
Canal spot	http://www.crosswordgiant.com/crossword-clue/282174/Canal-spot
Corncrib item	http://www.crosswordgiant.com/crossword-clue/293238/Corncrib-item
You may lend it or bend it	http://www.crosswordgiant.com/crossword-clue/297202/You-may-lend-it-or-bend-it
Part of ENT	http://www.crosswordgiant.com/crossword-clue/298781/Part-of-ENT
Part of a teacup	http://www.crosswordgiant.com/crossword-clue/313103/Part-of-a-teacup
Word with muff or flap	http://www.crosswordgiant.com/crossword-clue/313451/Word-with-muff-or-flap
Otology subject	http://www.crosswordgiant.com/crossword-clue/315776/Otology-subject
Place for a hammer	http://www.crosswordgiant.com/crossword-clue/316810/Place-for-a-hammer
___ canal	http://www.crosswordgiant.com/crossword-clue/317137/___-canal
'Lent' body part	http://www.crosswordgiant.com/crossword-clue/321395/Lent-body-part
Vulcan feature	http://www.crosswordgiant.com/crossword-clue/325236/Vulcan-feature
  Word with candy or drops	http://www.crosswordgiant.com/crossword-clue/325900/-Word-with-candy-or-drops
Traditionalist's piercing site	http://www.crosswordgiant.com/crossword-clue/326445/Traditionalists-piercing-site
Talent for music	http://www.crosswordgiant.com/crossword-clue/329211/Talent-for-music
Cerumen locale	http://www.crosswordgiant.com/crossword-clue/329531/Cerumen-locale
Corn purchase	http://www.crosswordgiant.com/crossword-clue/356688/Corn-purchase
Hoop locale	http://www.crosswordgiant.com/crossword-clue/382540/Hoop-locale
Listening device?	http://www.crosswordgiant.com/crossword-clue/391856/Listening-device
Distinctive Vulcan feature	http://www.crosswordgiant.com/crossword-clue/398341/Distinctive-Vulcan-feature
Plug place	http://www.crosswordgiant.com/crossword-clue/417072/Plug-place
Aptitude for note-worthy creations?	http://www.crosswordgiant.com/crossword-clue/435528/Aptitude-for-note-worthy-creations
Pencil holder, sometimes	http://www.crosswordgiant.com/crossword-clue/436553/Pencil-holder-sometimes
Otologist's subject	http://www.crosswordgiant.com/crossword-clue/442454/Otologists-subject
Corn amount	http://www.crosswordgiant.com/crossword-clue/442686/Corn-amount
Big part of an elephant	http://www.crosswordgiant.com/crossword-clue/444339/Big-part-of-an-elephant
ENT part	http://www.crosswordgiant.com/crossword-clue/446013/ENT-part
Traditional piercing site	http://www.crosswordgiant.com/crossword-clue/458664/Traditional-piercing-site
__ candy (pleasing music)	http://www.crosswordgiant.com/crossword-clue/472792/__-candy-pleasing-music
Anvil site	http://www.crosswordgiant.com/crossword-clue/477255/Anvil-site
Pitcher handle	http://www.crosswordgiant.com/crossword-clue/488821/Pitcher-handle
Melodic sense	http://www.crosswordgiant.com/crossword-clue/511716/Melodic-sense
Organ with a drum in it	http://www.crosswordgiant.com/crossword-clue/549608/Organ-with-a-drum-in-it
Sense of pitch	http://www.crosswordgiant.com/crossword-clue/613046/Sense-of-pitch
Inner ___	http://www.crosswordgiant.com/crossword-clue/614827/Inner-___
Audiologist's concern	http://www.crosswordgiant.com/crossword-clue/619865/Audiologists-concern
Clip-on locale	http://www.crosswordgiant.com/crossword-clue/627836/Clip-on-locale
''In one ___ and out the other''	http://www.crosswordgiant.com/crossword-clue/628849/In-one-___-and-out-the-other
Flair for music	http://www.crosswordgiant.com/crossword-clue/661822/Flair-for-music
A cricket has one below each front leg joint	http://www.crosswordgiant.com/crossword-clue/675288/A-cricket-has-one-below-each-front-leg-joint
Whisperer's target	http://www.crosswordgiant.com/crossword-clue/678758/Whisperers-target
Place for a headphone	http://www.crosswordgiant.com/crossword-clue/697591/Place-for-a-headphone
Cute as a bug's ___	http://www.crosswordgiant.com/crossword-clue/712003/Cute-as-a-bugs-___
Hammer-and-anvil site	http://www.crosswordgiant.com/crossword-clue/728131/Hammer-and-anvil-site
Something that may be pricked	http://www.crosswordgiant.com/crossword-clue/742115/Something-that-may-be-pricked
Anvil and stirrup site	http://www.crosswordgiant.com/crossword-clue/759848/Anvil-and-stirrup-site
A barber might nick it	http://www.crosswordgiant.com/crossword-clue/780187/A-barber-might-nick-it
Musicians gift	http://www.crosswordgiant.com/crossword-clue/837075/Musicians-gift
Where you'll find a stirrup	http://www.crosswordgiant.com/crossword-clue/850352/Where-youll-find-a-stirrup
Either end of a wide grin	http://www.crosswordgiant.com/crossword-clue/873226/Either-end-of-a-wide-grin
Swabbed spot	http://www.crosswordgiant.com/crossword-clue/900535/Swabbed-spot
Aural appendage	http://www.crosswordgiant.com/crossword-clue/958014/Aural-appendage
Spike of corn	http://www.crosswordgiant.com/crossword-clue/958232/Spike-of-corn
'Give every man thine ..., but few thy voice' (Hamlet)	http://www.crosswordgiant.com/crossword-clue/986283/Give-every-man-thine-...-but-few-thy-voice-Hamlet
Part of cereal plant containing seed	http://www.crosswordgiant.com/crossword-clue/1007639/Part-of-cereal-plant-containing-seed
Lend one and listen	http://www.crosswordgiant.com/crossword-clue/1018030/Lend-one-and-listen
Would sound as if that's what this is for	http://www.crosswordgiant.com/crossword-clue/1174144/Would-sound-as-if-thats-what-this-is-for
A sound operator	http://www.crosswordgiant.com/crossword-clue/1175350/A-sound-operator
A sound way to start 30 across	http://www.crosswordgiant.com/crossword-clue/1180631/A-sound-way-to-start-30-across
Pencil-parking place	http://www.crosswordgiant.com/crossword-clue/1200215/Pencil-parking-place
Place for a small hammer	http://www.crosswordgiant.com/crossword-clue/1486250/Place-for-a-small-hammer
Word with "muff" or "mark"	http://www.crosswordgiant.com/crossword-clue/1488178/Word-with-muff-or-mark
Wood ___ (fungus that grows on trees)	http://www.crosswordgiant.com/crossword-clue/1491908/Wood-___-fungus-that-grows-on-trees
Kernel carrier	http://www.crosswordgiant.com/crossword-clue/10891/Kernel-carrier
Tin ___	http://www.crosswordgiant.com/crossword-clue/14050/Tin-___
Audition	http://www.crosswordgiant.com/crossword-clue/25462/Audition
Ring spot	http://www.crosswordgiant.com/crossword-clue/27580/Ring-spot
Something to lend	http://www.crosswordgiant.com/crossword-clue/33260/Something-to-lend
Musician's pride	http://www.crosswordgiant.com/crossword-clue/35272/Musicians-pride
Notice	http://www.crosswordgiant.com/crossword-clue/46284/Notice
See 15-Across	http://www.crosswordgiant.com/crossword-clue/47585/See-15-Across
Piercing place	http://www.crosswordgiant.com/crossword-clue/47828/Piercing-place
It may be lent	http://www.crosswordgiant.com/crossword-clue/47918/It-may-be-lent
Sensitivity	http://www.crosswordgiant.com/crossword-clue/48015/Sensitivity
Ring bearer?	http://www.crosswordgiant.com/crossword-clue/48620/Ring-bearer
Keen perception	http://www.crosswordgiant.com/crossword-clue/53559/Keen-perception
It may be pulled	http://www.crosswordgiant.com/crossword-clue/55491/It-may-be-pulled
Site of a helix and antihelix	http://www.crosswordgiant.com/crossword-clue/56496/Site-of-a-helix-and-antihelix
Field unit	http://www.crosswordgiant.com/crossword-clue/68113/Field-unit
Dog-___	http://www.crosswordgiant.com/crossword-clue/77599/Dog-___
Word with drum or trumpet	http://www.crosswordgiant.com/crossword-clue/78649/Word-with-drum-or-trumpet
One sense, figuratively	http://www.crosswordgiant.com/crossword-clue/79228/One-sense-figuratively
Kind of drum or trumpet	http://www.crosswordgiant.com/crossword-clue/80122/Kind-of-drum-or-trumpet
Van Gogh's sacrifice	http://www.crosswordgiant.com/crossword-clue/108254/Van-Goghs-sacrifice
Piece of corn	http://www.crosswordgiant.com/crossword-clue/111716/Piece-of-corn
With 62-Down, animal identifier	http://www.crosswordgiant.com/crossword-clue/116069/With-62-Down-animal-identifier
11-Down location	http://www.crosswordgiant.com/crossword-clue/117581/11-Down-location
Type of phone	http://www.crosswordgiant.com/crossword-clue/120892/Type-of-phone
Cauliflower ---	http://www.crosswordgiant.com/crossword-clue/132504/Cauliflower-
Object near a temple	http://www.crosswordgiant.com/crossword-clue/133553/Object-near-a-temple
Cereal plant portion	http://www.crosswordgiant.com/crossword-clue/133922/Cereal-plant-portion
Big grin terminus?	http://www.crosswordgiant.com/crossword-clue/134946/Big-grin-terminus
Big grin stopping point	http://www.crosswordgiant.com/crossword-clue/138190/Big-grin-stopping-point
Where to find a hammer or anvil	http://www.crosswordgiant.com/crossword-clue/138898/Where-to-find-a-hammer-or-anvil
Holyfield's got Tyson into trouble	http://www.crosswordgiant.com/crossword-clue/148119/Holyfields-got-Tyson-into-trouble
Pass piercing option, nowadays	http://www.crosswordgiant.com/crossword-clue/151474/Pass-piercing-option-nowadays
It may be cocked	http://www.crosswordgiant.com/crossword-clue/163161/It-may-be-cocked
Ring location?	http://www.crosswordgiant.com/crossword-clue/163348/Ring-location
Drum locale	http://www.crosswordgiant.com/crossword-clue/166672/Drum-locale
It sticks out at the side	http://www.crosswordgiant.com/crossword-clue/169397/It-sticks-out-at-the-side
Listener's loan	http://www.crosswordgiant.com/crossword-clue/174738/Listeners-loan
Lendable organ	http://www.crosswordgiant.com/crossword-clue/186758/Lendable-organ
Spot for a headphone	http://www.crosswordgiant.com/crossword-clue/192226/Spot-for-a-headphone
Trophy handle	http://www.crosswordgiant.com/crossword-clue/209262/Trophy-handle
Head part	http://www.crosswordgiant.com/crossword-clue/213168/Head-part
Bean sprout?	http://www.crosswordgiant.com/crossword-clue/215991/Bean-sprout
Corrida trophy	http://www.crosswordgiant.com/crossword-clue/222623/Corrida-trophy
Corn order	http://www.crosswordgiant.com/crossword-clue/232695/Corn-order
Stalk outgrowth	http://www.crosswordgiant.com/crossword-clue/238397/Stalk-outgrowth
From whence to lug a jug	http://www.crosswordgiant.com/crossword-clue/244564/From-whence-to-lug-a-jug
Aural factory?	http://www.crosswordgiant.com/crossword-clue/246622/Aural-factory
Spike to shuck	http://www.crosswordgiant.com/crossword-clue/247219/Spike-to-shuck
Pitcher feature	http://www.crosswordgiant.com/crossword-clue/253153/Pitcher-feature
Ring  setting	http://www.crosswordgiant.com/crossword-clue/256404/Ring-setting
Stud's place	http://www.crosswordgiant.com/crossword-clue/259400/Studs-place
Kernel site	http://www.crosswordgiant.com/crossword-clue/262143/Kernel-site
Something to shuck	http://www.crosswordgiant.com/crossword-clue/270028/Something-to-shuck
Full attention	http://www.crosswordgiant.com/crossword-clue/270365/Full-attention
Head protrusion	http://www.crosswordgiant.com/crossword-clue/275188/Head-protrusion
Musician's boon	http://www.crosswordgiant.com/crossword-clue/277117/Musicians-boon
Musical acumen	http://www.crosswordgiant.com/crossword-clue/283399/Musical-acumen
Stirrup's locale	http://www.crosswordgiant.com/crossword-clue/285483/Stirrups-locale
Mr. Potato Head attachment	http://www.crosswordgiant.com/crossword-clue/291680/Mr.-Potato-Head-attachment
Place for a small drum?	http://www.crosswordgiant.com/crossword-clue/291691/Place-for-a-small-drum
Equilibrium provider	http://www.crosswordgiant.com/crossword-clue/293041/Equilibrium-provider
One of a boxed set?	http://www.crosswordgiant.com/crossword-clue/299515/One-of-a-boxed-set
Cochlea locale	http://www.crosswordgiant.com/crossword-clue/307098/Cochlea-locale
It's laid back on an angry horse	http://www.crosswordgiant.com/crossword-clue/309051/Its-laid-back-on-an-angry-horse
Hammer's home	http://www.crosswordgiant.com/crossword-clue/331210/Hammers-home
It helps keep one balanced	http://www.crosswordgiant.com/crossword-clue/331828/It-helps-keep-one-balanced
Drum organ	http://www.crosswordgiant.com/crossword-clue/334816/Drum-organ
Wax collector?	http://www.crosswordgiant.com/crossword-clue/338015/Wax-collector
It's lent by friends	http://www.crosswordgiant.com/crossword-clue/346979/Its-lent-by-friends
Sympathetic one's offering	http://www.crosswordgiant.com/crossword-clue/348857/Sympathetic-ones-offering
It may be pulled or bent	http://www.crosswordgiant.com/crossword-clue/349600/It-may-be-pulled-or-bent
Spike, as of grain	http://www.crosswordgiant.com/crossword-clue/354072/Spike-as-of-grain
Oft-pierced body part	http://www.crosswordgiant.com/crossword-clue/354952/Oft-pierced-body-part
It's part of a head	http://www.crosswordgiant.com/crossword-clue/374076/Its-part-of-a-head
Spike	http://www.crosswordgiant.com/crossword-clue/374908/Spike
Eustachian tube site	http://www.crosswordgiant.com/crossword-clue/378542/Eustachian-tube-site
Rock-concert ringer	http://www.crosswordgiant.com/crossword-clue/379351/Rock-concert-ringer
Phone attachment?	http://www.crosswordgiant.com/crossword-clue/381317/Phone-attachment
Ring or phone lead-in	http://www.crosswordgiant.com/crossword-clue/381532/Ring-or-phone-lead-in
With 19 Down, otalgia	http://www.crosswordgiant.com/crossword-clue/387479/With-19-Down-otalgia
Big feature of an elephant	http://www.crosswordgiant.com/crossword-clue/387977/Big-feature-of-an-elephant
It may be sympathetic	http://www.crosswordgiant.com/crossword-clue/391135/It-may-be-sympathetic
Word with drops or canal	http://www.crosswordgiant.com/crossword-clue/392125/Word-with-drops-or-canal
Spike in a field	http://www.crosswordgiant.com/crossword-clue/393165/Spike-in-a-field
Hoop holder	http://www.crosswordgiant.com/crossword-clue/402954/Hoop-holder
Vertigo setting	http://www.crosswordgiant.com/crossword-clue/403765/Vertigo-setting
Whispering place	http://www.crosswordgiant.com/crossword-clue/407859/Whispering-place
Mr. Potato Head part	http://www.crosswordgiant.com/crossword-clue/408305/Mr.-Potato-Head-part
___ candy (pop music)	http://www.crosswordgiant.com/crossword-clue/411627/___-candy-pop-music
Body part associated with Van Gogh	http://www.crosswordgiant.com/crossword-clue/413938/Body-part-associated-with-Van-Gogh
Wide grin terminus	http://www.crosswordgiant.com/crossword-clue/415531/Wide-grin-terminus
Word with wax or phone	http://www.crosswordgiant.com/crossword-clue/421548/Word-with-wax-or-phone
Word with muff or mark	http://www.crosswordgiant.com/crossword-clue/421974/Word-with-muff-or-mark
Grin's boundary, so it's said	http://www.crosswordgiant.com/crossword-clue/423681/Grins-boundary-so-its-said
Conductor's need	http://www.crosswordgiant.com/crossword-clue/424119/Conductors-need
Place for a ring?	http://www.crosswordgiant.com/crossword-clue/432426/Place-for-a-ring
A hole in the head?	http://www.crosswordgiant.com/crossword-clue/434589/A-hole-in-the-head
Lendable part?	http://www.crosswordgiant.com/crossword-clue/436347/Lendable-part
End point for an iPod cord	http://www.crosswordgiant.com/crossword-clue/440467/End-point-for-an-iPod-cord
It may be pierced	http://www.crosswordgiant.com/crossword-clue/441190/It-may-be-pierced
Organ near a temple?	http://www.crosswordgiant.com/crossword-clue/444065/Organ-near-a-temple
Word with wax or drops	http://www.crosswordgiant.com/crossword-clue/446266/Word-with-wax-or-drops
Spike in a grain field	http://www.crosswordgiant.com/crossword-clue/447454/Spike-in-a-grain-field
Stirrup spot	http://www.crosswordgiant.com/crossword-clue/449061/Stirrup-spot
It's often next to a phone	http://www.crosswordgiant.com/crossword-clue/452979/Its-often-next-to-a-phone
Cobful of corn	http://www.crosswordgiant.com/crossword-clue/455939/Cobful-of-corn
Drop target, sometimes	http://www.crosswordgiant.com/crossword-clue/459378/Drop-target-sometimes
Sensor	http://www.crosswordgiant.com/crossword-clue/464842/Sensor
Auditory nerve's locale	http://www.crosswordgiant.com/crossword-clue/471992/Auditory-nerves-locale
Sound detector	http://www.crosswordgiant.com/crossword-clue/474653/Sound-detector
What barotrauma affects	http://www.crosswordgiant.com/crossword-clue/478023/What-barotrauma-affects
Prominent part of a dachshund	http://www.crosswordgiant.com/crossword-clue/478297/Prominent-part-of-a-dachshund
Otic organ	http://www.crosswordgiant.com/crossword-clue/478949/Otic-organ
Ache site	http://www.crosswordgiant.com/crossword-clue/483998/Ache-site
Locale of a small stirrup	http://www.crosswordgiant.com/crossword-clue/486565/Locale-of-a-small-stirrup
Musical attunement	http://www.crosswordgiant.com/crossword-clue/493409/Musical-attunement
Word with ''mark'' or ''splitting''	http://www.crosswordgiant.com/crossword-clue/494651/Word-with-mark-or-splitting
Organ with a lobe	http://www.crosswordgiant.com/crossword-clue/496753/Organ-with-a-lobe
Sound system component?	http://www.crosswordgiant.com/crossword-clue/497860/Sound-system-component
Bean sprout?	http://www.crosswordgiant.com/crossword-clue/498323/Bean-sprout
Piercing target	http://www.crosswordgiant.com/crossword-clue/500291/Piercing-target
Otologist's concern	http://www.crosswordgiant.com/crossword-clue/502868/Otologists-concern
See 32 Down	http://www.crosswordgiant.com/crossword-clue/503416/See-32-Down
Cauliflower, maybe	http://www.crosswordgiant.com/crossword-clue/505453/Cauliflower-maybe
Van Gogh sacrifice	http://www.crosswordgiant.com/crossword-clue/508371/Van-Gogh-sacrifice
Good hearing	http://www.crosswordgiant.com/crossword-clue/511224/Good-hearing
Tonal sense	http://www.crosswordgiant.com/crossword-clue/515773/Tonal-sense
11 Down portion	http://www.crosswordgiant.com/crossword-clue/519078/11-Down-portion
Lend an __ (listen)	http://www.crosswordgiant.com/crossword-clue/525176/Lend-an-__-listen
Place for a stirrup	http://www.crosswordgiant.com/crossword-clue/526212/Place-for-a-stirrup
Sound catcher	http://www.crosswordgiant.com/crossword-clue/526217/Sound-catcher
Cellist's gift	http://www.crosswordgiant.com/crossword-clue/527816/Cellists-gift
Where a phone is held	http://www.crosswordgiant.com/crossword-clue/532803/Where-a-phone-is-held
Common ache site	http://www.crosswordgiant.com/crossword-clue/536415/Common-ache-site
Lend an ____	http://www.crosswordgiant.com/crossword-clue/536657/Lend-an-____
Ring bearer, at times	http://www.crosswordgiant.com/crossword-clue/541765/Ring-bearer-at-times
Side flap	http://www.crosswordgiant.com/crossword-clue/542366/Side-flap
Bud holder?	http://www.crosswordgiant.com/crossword-clue/546121/Bud-holder
Big elephant feature	http://www.crosswordgiant.com/crossword-clue/546323/Big-elephant-feature
Cornfield unit	http://www.crosswordgiant.com/crossword-clue/547259/Cornfield-unit
Place to find a stud?	http://www.crosswordgiant.com/crossword-clue/550445/Place-to-find-a-stud
Dumbo's 'wing'	http://www.crosswordgiant.com/crossword-clue/552947/Dumbos-wing
Hearing location	http://www.crosswordgiant.com/crossword-clue/557371/Hearing-location
It's needed to find the right key	http://www.crosswordgiant.com/crossword-clue/559351/Its-needed-to-find-the-right-key
It has its own drum	http://www.crosswordgiant.com/crossword-clue/562185/It-has-its-own-drum
Auditory sensor	http://www.crosswordgiant.com/crossword-clue/562780/Auditory-sensor
Hoop site, maybe	http://www.crosswordgiant.com/crossword-clue/565640/Hoop-site-maybe
Cereal spike	http://www.crosswordgiant.com/crossword-clue/567107/Cereal-spike
Where the utricle is	http://www.crosswordgiant.com/crossword-clue/576787/Where-the-utricle-is
Word with mark or muff	http://www.crosswordgiant.com/crossword-clue/582212/Word-with-mark-or-muff
Cochlea's locale	http://www.crosswordgiant.com/crossword-clue/583255/Cochleas-locale
Organ for an otolaryngologist	http://www.crosswordgiant.com/crossword-clue/587955/Organ-for-an-otolaryngologist
Van Gogh wound up with one	http://www.crosswordgiant.com/crossword-clue/589251/Van-Gogh-wound-up-with-one
Musician's asset	http://www.crosswordgiant.com/crossword-clue/589475/Musicians-asset
Corn part	http://www.crosswordgiant.com/crossword-clue/589497/Corn-part
Where the antihelix is	http://www.crosswordgiant.com/crossword-clue/591516/Where-the-antihelix-is
Wheat spike	http://www.crosswordgiant.com/crossword-clue/593840/Wheat-spike
Where you might see the last word of 20-, 32-, 41- and 53-Across	http://www.crosswordgiant.com/crossword-clue/594393/Where-you-might-see-the-last-word-of-20-32-41-and-53-Across
Pencil holder, often	http://www.crosswordgiant.com/crossword-clue/596713/Pencil-holder-often
Prominent Chihuahua feature	http://www.crosswordgiant.com/crossword-clue/597617/Prominent-Chihuahua-feature
___ candy (some pop tunes)	http://www.crosswordgiant.com/crossword-clue/599648/___-candy-some-pop-tunes
Wave catcher?	http://www.crosswordgiant.com/crossword-clue/600382/Wave-catcher
Add one letter, and you have an explanation of what it does	http://www.crosswordgiant.com/crossword-clue/604892/Add-one-letter-and-you-have-an-explanation-of-what-it-does
Tossed out on one's ___	http://www.crosswordgiant.com/crossword-clue/605664/Tossed-out-on-ones-___
It's used when looking for the right key	http://www.crosswordgiant.com/crossword-clue/606942/Its-used-when-looking-for-the-right-key
Corn container?	http://www.crosswordgiant.com/crossword-clue/612164/Corn-container
Iowa harvest unit	http://www.crosswordgiant.com/crossword-clue/612816/Iowa-harvest-unit
One may be bent	http://www.crosswordgiant.com/crossword-clue/622243/One-may-be-bent
Ossicles' site	http://www.crosswordgiant.com/crossword-clue/623431/Ossicles-site
Place for a 59-Down	http://www.crosswordgiant.com/crossword-clue/626515/Place-for-a-59-Down
Word with ''drop'' or ''drum''	http://www.crosswordgiant.com/crossword-clue/628552/Word-with-drop-or-drum
Temple neighbor	http://www.crosswordgiant.com/crossword-clue/632310/Temple-neighbor
Pinna's place	http://www.crosswordgiant.com/crossword-clue/632835/Pinnas-place
It can be swabbed	http://www.crosswordgiant.com/crossword-clue/635524/It-can-be-swabbed
Cauliflower ___	http://www.crosswordgiant.com/crossword-clue/641254/Cauliflower-___
It may ring or have a ring	http://www.crosswordgiant.com/crossword-clue/641650/It-may-ring-or-have-a-ring
Glasses support	http://www.crosswordgiant.com/crossword-clue/643638/Glasses-support
With 12-Down, catchy pop music	http://www.crosswordgiant.com/crossword-clue/645638/With-12-Down-catchy-pop-music
Play it by --	http://www.crosswordgiant.com/crossword-clue/649075/Play-it-by-
It may be cupped or cuffed	http://www.crosswordgiant.com/crossword-clue/651277/It-may-be-cupped-or-cuffed
A hoop may be attached to it	http://www.crosswordgiant.com/crossword-clue/651920/A-hoop-may-be-attached-to-it
Where the incus bone is	http://www.crosswordgiant.com/crossword-clue/652977/Where-the-incus-bone-is
Word with canal or drum	http://www.crosswordgiant.com/crossword-clue/653397/Word-with-canal-or-drum
____ Falls, Ontario	http://www.crosswordgiant.com/crossword-clue/654907/____-Falls-Ontario
Site of an anatomical labyrinth	http://www.crosswordgiant.com/crossword-clue/656475/Site-of-an-anatomical-labyrinth
Singer's asset	http://www.crosswordgiant.com/crossword-clue/657109/Singers-asset
Thermometer insertion point, perhaps	http://www.crosswordgiant.com/crossword-clue/664273/Thermometer-insertion-point-perhaps
Type of wax	http://www.crosswordgiant.com/crossword-clue/664771/Type-of-wax
Pitching asset?	http://www.crosswordgiant.com/crossword-clue/664991/Pitching-asset
Bud's spot	http://www.crosswordgiant.com/crossword-clue/666251/Buds-spot
Bud's spot	http://www.crosswordgiant.com/crossword-clue/666728/Buds-spot
What a barber has to trim around	http://www.crosswordgiant.com/crossword-clue/673162/What-a-barber-has-to-trim-around
Drum and canal locale	http://www.crosswordgiant.com/crossword-clue/677070/Drum-and-canal-locale
The 'E' in 64-Across	http://www.crosswordgiant.com/crossword-clue/685676/The-E-in-64-Across
83 Across's location	http://www.crosswordgiant.com/crossword-clue/687105/83-Acrosss-location
Van Gogh's loss	http://www.crosswordgiant.com/crossword-clue/687816/Van-Goghs-loss
Crooner's asset	http://www.crosswordgiant.com/crossword-clue/695915/Crooners-asset
Prominent donkey feature	http://www.crosswordgiant.com/crossword-clue/698573/Prominent-donkey-feature
Musician's gift	http://www.crosswordgiant.com/crossword-clue/700439/Musicians-gift
Tarsus : foot :: incus : ___	http://www.crosswordgiant.com/crossword-clue/702008/Tarsus-foot-incus-___
Musician's asset	http://www.crosswordgiant.com/crossword-clue/706519/Musicians-asset
It's used to find the right key	http://www.crosswordgiant.com/crossword-clue/707008/Its-used-to-find-the-right-key
Sound receptor	http://www.crosswordgiant.com/crossword-clue/710968/Sound-receptor
Musician's asset	http://www.crosswordgiant.com/crossword-clue/714695/Musicians-asset
Where to find a cochlea	http://www.crosswordgiant.com/crossword-clue/715639/Where-to-find-a-cochlea
Obstacle for a barber	http://www.crosswordgiant.com/crossword-clue/720790/Obstacle-for-a-barber
Folded corner	http://www.crosswordgiant.com/crossword-clue/725155/Folded-corner
Site of semicircular canals	http://www.crosswordgiant.com/crossword-clue/725766/Site-of-semicircular-canals
It may pop on a plane	http://www.crosswordgiant.com/crossword-clue/727641/It-may-pop-on-a-plane
Stirrup's site	http://www.crosswordgiant.com/crossword-clue/729160/Stirrups-site
Ability to hear notes	http://www.crosswordgiant.com/crossword-clue/733369/Ability-to-hear-notes
Corn helping	http://www.crosswordgiant.com/crossword-clue/736331/Corn-helping
Musical cognizance	http://www.crosswordgiant.com/crossword-clue/736336/Musical-cognizance
It might get a plug	http://www.crosswordgiant.com/crossword-clue/737336/It-might-get-a-plug
It may be floppy or pointy	http://www.crosswordgiant.com/crossword-clue/738471/It-may-be-floppy-or-pointy
It's connected to the Eustachian tube	http://www.crosswordgiant.com/crossword-clue/738644/Its-connected-to-the-Eustachian-tube
What an aurilave cleans	http://www.crosswordgiant.com/crossword-clue/739901/What-an-aurilave-cleans
A musical talent	http://www.crosswordgiant.com/crossword-clue/740145/A-musical-talent
Anvil's site	http://www.crosswordgiant.com/crossword-clue/743061/Anvils-site
There can be a ring in it or on it	http://www.crosswordgiant.com/crossword-clue/743069/There-can-be-a-ring-in-it-or-on-it
It may be cocked or cupped	http://www.crosswordgiant.com/crossword-clue/744394/It-may-be-cocked-or-cupped
Whisperer's target	http://www.crosswordgiant.com/crossword-clue/744630/Whisperers-target
Cob + kernels	http://www.crosswordgiant.com/crossword-clue/754897/Cob-kernels
Something to lend a storyteller?	http://www.crosswordgiant.com/crossword-clue/758086/Something-to-lend-a-storyteller
Human body part with vestigial muscles	http://www.crosswordgiant.com/crossword-clue/759544/Human-body-part-with-vestigial-muscles
Auditory canal locale	http://www.crosswordgiant.com/crossword-clue/768342/Auditory-canal-locale
Word with "flap" or "drum"	http://www.crosswordgiant.com/crossword-clue/771627/Word-with-flap-or-drum
Shucker's unit	http://www.crosswordgiant.com/crossword-clue/771846/Shuckers-unit
Otologist's concern	http://www.crosswordgiant.com/crossword-clue/777991/Otologists-concern
Organ with a hammer	http://www.crosswordgiant.com/crossword-clue/779501/Organ-with-a-hammer
Semicircular-canal site	http://www.crosswordgiant.com/crossword-clue/782834/Semicircular-canal-site
Swab's target	http://www.crosswordgiant.com/crossword-clue/784816/Swabs-target
Word before 'buds'	http://www.crosswordgiant.com/crossword-clue/785462/Word-before-buds
Musician's asset	http://www.crosswordgiant.com/crossword-clue/794929/Musicians-asset
Topic of corn-versation?	http://www.crosswordgiant.com/crossword-clue/808421/Topic-of-corn-versation
Thing to bend or lend	http://www.crosswordgiant.com/crossword-clue/809653/Thing-to-bend-or-lend
Lend an _____	http://www.crosswordgiant.com/crossword-clue/809922/Lend-an-_____
Pencil holder?	http://www.crosswordgiant.com/crossword-clue/810313/Pencil-holder
Elephant's floppy feature	http://www.crosswordgiant.com/crossword-clue/813699/Elephants-floppy-feature
Stirrup locale	http://www.crosswordgiant.com/crossword-clue/815388/Stirrup-locale
Musical aptitude, of a sort	http://www.crosswordgiant.com/crossword-clue/820487/Musical-aptitude-of-a-sort
Musical acuity	http://www.crosswordgiant.com/crossword-clue/823980/Musical-acuity
Place to put a bud	http://www.crosswordgiant.com/crossword-clue/825705/Place-to-put-a-bud
Hammer and anvil setting	http://www.crosswordgiant.com/crossword-clue/835517/Hammer-and-anvil-setting
Shucker's unit	http://www.crosswordgiant.com/crossword-clue/837961/Shuckers-unit
Pink Mr. Potato Head piece	http://www.crosswordgiant.com/crossword-clue/842656/Pink-Mr.-Potato-Head-piece
Whisperer's target	http://www.crosswordgiant.com/crossword-clue/843335/Whisperers-target
Sideburn neighbor	http://www.crosswordgiant.com/crossword-clue/845152/Sideburn-neighbor
Ability to appreciate music	http://www.crosswordgiant.com/crossword-clue/846363/Ability-to-appreciate-music
Audiology subject	http://www.crosswordgiant.com/crossword-clue/846369/Audiology-subject
Van Gogh's missing piece?	http://www.crosswordgiant.com/crossword-clue/848979/Van-Goghs-missing-piece
Where you'll find a stirrup	http://www.crosswordgiant.com/crossword-clue/850167/Where-youll-find-a-stirrup
Kernel source	http://www.crosswordgiant.com/crossword-clue/852105/Kernel-source
Part of a corn plant	http://www.crosswordgiant.com/crossword-clue/854064/Part-of-a-corn-plant
Traditionalist's piercing site	http://www.crosswordgiant.com/crossword-clue/854277/Traditionalists-piercing-site
Barber's obstacle	http://www.crosswordgiant.com/crossword-clue/854758/Barbers-obstacle
Eustachian tube locale	http://www.crosswordgiant.com/crossword-clue/856039/Eustachian-tube-locale
You might play something by this	http://www.crosswordgiant.com/crossword-clue/859839/You-might-play-something-by-this
Elephant's-___ (plant)	http://www.crosswordgiant.com/crossword-clue/862472/Elephants-___-plant
A pencil may be parked behind here	http://www.crosswordgiant.com/crossword-clue/866056/A-pencil-may-be-parked-behind-here
Musical skill	http://www.crosswordgiant.com/crossword-clue/869823/Musical-skill
Song played at the school dance in 'Back to the Future'	http://www.crosswordgiant.com/crossword-clue/870062/Song-played-at-the-school-dance-in-Back-to-the-Future
Where to hold a telephone receiver	http://www.crosswordgiant.com/crossword-clue/871209/Where-to-hold-a-telephone-receiver
Where the smallest bones in the body are located	http://www.crosswordgiant.com/crossword-clue/871608/Where-the-smallest-bones-in-the-body-are-located
Improviser's asset	http://www.crosswordgiant.com/crossword-clue/873434/Improvisers-asset
Ring holder ... or receiver?	http://www.crosswordgiant.com/crossword-clue/875641/Ring-holder-...-or-receiver
Piercing locale	http://www.crosswordgiant.com/crossword-clue/878951/Piercing-locale
Otologist's focus	http://www.crosswordgiant.com/crossword-clue/881300/Otologists-focus
Place to whisper sweet nothings	http://www.crosswordgiant.com/crossword-clue/882014/Place-to-whisper-sweet-nothings
Bud's place	http://www.crosswordgiant.com/crossword-clue/885417/Buds-place
Word with "drop" or "drum"	http://www.crosswordgiant.com/crossword-clue/887302/Word-with-drop-or-drum
Where 76-Across may be worn	http://www.crosswordgiant.com/crossword-clue/892092/Where-76-Across-may-be-worn
Makeshift pencil holder	http://www.crosswordgiant.com/crossword-clue/892500/Makeshift-pencil-holder
Elephant's ___ (plant)	http://www.crosswordgiant.com/crossword-clue/892504/Elephants-___-plant
Teacup part	http://www.crosswordgiant.com/crossword-clue/893265/Teacup-part
__ candy	http://www.crosswordgiant.com/crossword-clue/896788/__-candy
Pierced organ	http://www.crosswordgiant.com/crossword-clue/896992/Pierced-organ
Musician's asset	http://www.crosswordgiant.com/crossword-clue/901931/Musicians-asset
Tyson's infamous biting target	http://www.crosswordgiant.com/crossword-clue/902761/Tysons-infamous-biting-target
Poor listener's in-and-out organ	http://www.crosswordgiant.com/crossword-clue/904179/Poor-listeners-in-and-out-organ
Tin ___ (lack of musical sense)	http://www.crosswordgiant.com/crossword-clue/904381/Tin-___-lack-of-musical-sense
Organ that might be tin?	http://www.crosswordgiant.com/crossword-clue/909060/Organ-that-might-be-tin
It's near a temple	http://www.crosswordgiant.com/crossword-clue/911508/Its-near-a-temple
Cute as a bug's ___	http://www.crosswordgiant.com/crossword-clue/912085/Cute-as-a-bugs-___
Van Gogh lost one	http://www.crosswordgiant.com/crossword-clue/913018/Van-Gogh-lost-one
Husker's handful	http://www.crosswordgiant.com/crossword-clue/914266/Huskers-handful
''In one __ and out . . .''	http://www.crosswordgiant.com/crossword-clue/916066/In-one-__-and-out-.-.-
Musical sound receiver	http://www.crosswordgiant.com/crossword-clue/935535/Musical-sound-receiver
It can ache	http://www.crosswordgiant.com/crossword-clue/936784/It-can-ache
Listener in the cornfield	http://www.crosswordgiant.com/crossword-clue/961860/Listener-in-the-cornfield
Bionic part of the Bionic Woman	http://www.crosswordgiant.com/crossword-clue/961903/Bionic-part-of-the-Bionic-Woman
Organ for hearing	http://www.crosswordgiant.com/crossword-clue/971812/Organ-for-hearing
Fruiting head of a cereal	http://www.crosswordgiant.com/crossword-clue/984313/Fruiting-head-of-a-cereal
Organ inside heart	http://www.crosswordgiant.com/crossword-clue/989972/Organ-inside-heart
'Give every man thine ..., but few thy voice'/Hamlet	http://www.crosswordgiant.com/crossword-clue/995604/Give-every-man-thine-...-but-few-thy-voiceHamlet
Dumbo's wing	http://www.crosswordgiant.com/crossword-clue/1019202/Dumbos-wing
Seed-bearing part of corn	http://www.crosswordgiant.com/crossword-clue/1022417/Seed-bearing-part-of-corn
'Give every man thine . . ., but few thy voice' (Hamlet)	http://www.crosswordgiant.com/crossword-clue/1028616/Give-every-man-thine-.-.-.-but-few-thy-voice-Hamlet
Van Gogh missing body part	http://www.crosswordgiant.com/crossword-clue/1031396/Van-Gogh-missing-body-part
Sensory organ	http://www.crosswordgiant.com/crossword-clue/1034446/Sensory-organ
Going on ahead in 17 across	http://www.crosswordgiant.com/crossword-clue/1047521/Going-on-ahead-in-17-across
Sound enough to get a noble half-century	http://www.crosswordgiant.com/crossword-clue/1047590/Sound-enough-to-get-a-noble-half-century
For the sound of what you get.	http://www.crosswordgiant.com/crossword-clue/1048918/For-the-sound-of-what-you-get
Then afterwards it gets soiled, perhaps	http://www.crosswordgiant.com/crossword-clue/1050350/Then-afterwards-it-gets-soiled-perhaps
Sound enough to be noble before half a century	http://www.crosswordgiant.com/crossword-clue/1050951/Sound-enough-to-be-noble-before-half-a-century
This nest had some importance for Wilde	http://www.crosswordgiant.com/crossword-clue/1051894/This-nest-had-some-importance-for-Wilde
By the sound of it, one knows it's round the corner	http://www.crosswordgiant.com/crossword-clue/1057732/By-the-sound-of-it-one-knows-its-round-the-corner
That would make a sound, sincere sort of nest	http://www.crosswordgiant.com/crossword-clue/1060581/That-would-make-a-sound-sincere-sort-of-nest
Could be the nest of wildsounding importance	http://www.crosswordgiant.com/crossword-clue/1062423/Could-be-the-nest-of-wildsounding-importance
From this you get the sound of the end of 28 across	http://www.crosswordgiant.com/crossword-clue/1062589/From-this-you-get-the-sound-of-the-end-of-28-across
Fifty could make a noble addition to this, and get sound	http://www.crosswordgiant.com/crossword-clue/1067149/Fifty-could-make-a-noble-addition-to-this-and-get-sound
The nipper might go on ahead like this with a wig	http://www.crosswordgiant.com/crossword-clue/1070302/The-nipper-might-go-on-ahead-like-this-with-a-wig
That would be souondly noble before half a century	http://www.crosswordgiant.com/crossword-clue/1076350/That-would-be-souondly-noble-before-half-a-century
Noble for over haly a century	http://www.crosswordgiant.com/crossword-clue/1077525/Noble-for-over-haly-a-century
By the sound of it, this gets it	http://www.crosswordgiant.com/crossword-clue/1078495/By-the-sound-of-it-this-gets-it
Thy addition would make it crude	http://www.crosswordgiant.com/crossword-clue/1079560/Thy-addition-would-make-it-crude
One goes on ahead	http://www.crosswordgiant.com/crossword-clue/1082094/One-goes-on-ahead
That gets everything, by the sound of it	http://www.crosswordgiant.com/crossword-clue/1084320/That-gets-everything-by-the-sound-of-it
It's sound on ahead	http://www.crosswordgiant.com/crossword-clue/1084778/Its-sound-on-ahead
Could the nest be really meaning to get so sound as this?	http://www.crosswordgiant.com/crossword-clue/1086755/Could-the-nest-be-really-meaning-to-get-so-sound-as-this
That could be the thing that makes this so sound	http://www.crosswordgiant.com/crossword-clue/1087886/That-could-be-the-thing-that-makes-this-so-sound
Might get sound on one of 8 down	http://www.crosswordgiant.com/crossword-clue/1089853/Might-get-sound-on-one-of-8-down
It would take half a century to make that organ noble	http://www.crosswordgiant.com/crossword-clue/1092467/It-would-take-half-a-century-to-make-that-organ-noble
The nest that is important being on ahead	http://www.crosswordgiant.com/crossword-clue/1093827/The-nest-that-is-important-being-on-ahead
That'll get it, by the sound of it	http://www.crosswordgiant.com/crossword-clue/1096843/Thatll-get-it-by-the-sound-of-it
That's one that goes on ahead	http://www.crosswordgiant.com/crossword-clue/1099177/Thats-one-that-goes-on-ahead
This would make the nest serious, by the sound of it	http://www.crosswordgiant.com/crossword-clue/1099442/This-would-make-the-nest-serious-by-the-sound-of-it
This gets one sound enough to get a title before one gets to fifty	http://www.crosswordgiant.com/crossword-clue/1104542/This-gets-one-sound-enough-to-get-a-title-before-one-gets-to-fifty
The sort of nest that is really meant to be sound	http://www.crosswordgiant.com/crossword-clue/1105097/The-sort-of-nest-that-is-really-meant-to-be-sound
It would make one love to end this on ahead	http://www.crosswordgiant.com/crossword-clue/1107310/It-would-make-one-love-to-end-this-on-ahead
Go on ahead and get a title before you get to fifty (3)	http://www.crosswordgiant.com/crossword-clue/1107914/Go-on-ahead-and-get-a-title-before-you-get-to-fifty-3
What Ned may have deserved to get with this, by the sound of it	http://www.crosswordgiant.com/crossword-clue/1113846/What-Ned-may-have-deserved-to-get-with-this-by-the-sound-of-it
Get sound in pairs on 12 across	http://www.crosswordgiant.com/crossword-clue/1114044/Get-sound-in-pairs-on-12-across
One will get it through this, by the sound of it	http://www.crosswordgiant.com/crossword-clue/1119843/One-will-get-it-through-this-by-the-sound-of-it
That's going on ahead, by the sound of it	http://www.crosswordgiant.com/crossword-clue/1122414/Thats-going-on-ahead-by-the-sound-of-it
A sound start for 28 across	http://www.crosswordgiant.com/crossword-clue/1122583/A-sound-start-for-28-across
That will get it, by the sound of it	http://www.crosswordgiant.com/crossword-clue/1123563/That-will-get-it-by-the-sound-of-it
One goes on ahead for a little after fifty	http://www.crosswordgiant.com/crossword-clue/1124871/One-goes-on-ahead-for-a-little-after-fifty
Go on ahead and be noble before fifty	http://www.crosswordgiant.com/crossword-clue/1126592/Go-on-ahead-and-be-noble-before-fifty
Go on ahead for the sound of it (3)	http://www.crosswordgiant.com/crossword-clue/1129618/Go-on-ahead-for-the-sound-of-it-3
One goes on ahead, by the sound of it	http://www.crosswordgiant.com/crossword-clue/1130806/One-goes-on-ahead-by-the-sound-of-it
One can go on ahead and be noble before fifty	http://www.crosswordgiant.com/crossword-clue/1133345/One-can-go-on-ahead-and-be-noble-before-fifty
This will enable one to get it, by the sound of it	http://www.crosswordgiant.com/crossword-clue/1139252/This-will-enable-one-to-get-it-by-the-sound-of-it
Sound enough to peer at it if it's over fifty	http://www.crosswordgiant.com/crossword-clue/1140379/Sound-enough-to-peer-at-it-if-its-over-fifty
Needs thy presence to get ground on ahead	http://www.crosswordgiant.com/crossword-clue/1141047/Needs-thy-presence-to-get-ground-on-ahead
Acoustic organ?	http://www.crosswordgiant.com/crossword-clue/1142667/Acoustic-organ
It's sound enough to go on ahead	http://www.crosswordgiant.com/crossword-clue/1143458/Its-sound-enough-to-go-on-ahead
One goes on ahead by the sound of it	http://www.crosswordgiant.com/crossword-clue/1145603/One-goes-on-ahead-by-the-sound-of-it
That gives 22 across a sound start	http://www.crosswordgiant.com/crossword-clue/1145638/That-gives-22-across-a-sound-start
Get sound going on ahead of 15 across	http://www.crosswordgiant.com/crossword-clue/1146095/Get-sound-going-on-ahead-of-15-across
Go on ahead - on the head of 3 down	http://www.crosswordgiant.com/crossword-clue/1148823/Go-on-ahead-on-the-head-of-3-down
Get sound on ahead with it	http://www.crosswordgiant.com/crossword-clue/1150727/Get-sound-on-ahead-with-it
It would get really sound with the nest	http://www.crosswordgiant.com/crossword-clue/1152505/It-would-get-really-sound-with-the-nest
One gets 24 across through this	http://www.crosswordgiant.com/crossword-clue/1153868/One-gets-24-across-through-this
What got him sound Ned deserved	http://www.crosswordgiant.com/crossword-clue/1157834/What-got-him-sound-Ned-deserved
This, then, might be soiled but sound	http://www.crosswordgiant.com/crossword-clue/1159412/This-then-might-be-soiled-but-sound
Going on ahead, I would get soiled with thy help	http://www.crosswordgiant.com/crossword-clue/1167234/Going-on-ahead-I-would-get-soiled-with-thy-help
One will go on ahead to get the sound of it	http://www.crosswordgiant.com/crossword-clue/1167818/One-will-go-on-ahead-to-get-the-sound-of-it
Might this be thy sound ground?	http://www.crosswordgiant.com/crossword-clue/1167911/Might-this-be-thy-sound-ground
It must go on ahead to get the sound of it	http://www.crosswordgiant.com/crossword-clue/1168491/It-must-go-on-ahead-to-get-the-sound-of-it
'This, then, might soil the organ (3)'	http://www.crosswordgiant.com/crossword-clue/1169865/This-then-might-soil-the-organ-3
'Then after this goes on ahead for it to be soiled, perhaps (3)'	http://www.crosswordgiant.com/crossword-clue/1170234/Then-after-this-goes-on-ahead-for-it-to-be-soiled-perhaps-3
Pencil holder, maybe	http://www.crosswordgiant.com/crossword-clue/1197038/Pencil-holder-maybe
It's beside a sideburn	http://www.crosswordgiant.com/crossword-clue/1198006/Its-beside-a-sideburn
Goes on ahead for the sound of it	http://www.crosswordgiant.com/crossword-clue/1202677/Goes-on-ahead-for-the-sound-of-it
Pointy Spock feature	http://www.crosswordgiant.com/crossword-clue/1205799/Pointy-Spock-feature
It contains a human drum	http://www.crosswordgiant.com/crossword-clue/1206366/It-contains-a-human-drum
Hoop spot	http://www.crosswordgiant.com/crossword-clue/1206695/Hoop-spot
Shape of orecchietta pasta	http://www.crosswordgiant.com/crossword-clue/1208602/Shape-of-orecchietta-pasta
Lend an ___	http://www.crosswordgiant.com/crossword-clue/1209297/Lend-an-___
Tuner's talent	http://www.crosswordgiant.com/crossword-clue/1211200/Tuners-talent
Lobed thing	http://www.crosswordgiant.com/crossword-clue/1211215/Lobed-thing
It's semi-linear and it can be bent	http://www.crosswordgiant.com/crossword-clue/1212731/Its-semi-linear-and-it-can-be-bent
51-Across target	http://www.crosswordgiant.com/crossword-clue/1213156/51-Across-target
Van Gogh: ___ today, gone tomorrow?	http://www.crosswordgiant.com/crossword-clue/1213850/Van-Gogh-___-today-gone-tomorrow
Place to put a plug	http://www.crosswordgiant.com/crossword-clue/1216243/Place-to-put-a-plug
What the blind man who thought the elephant was 'like a fan' touched	http://www.crosswordgiant.com/crossword-clue/1216244/What-the-blind-man-who-thought-the-elephant-was-like-a-fan-touched
Listen, with this it's something to loan to Mark Antony	http://www.crosswordgiant.com/crossword-clue/1216554/Listen-with-this-its-something-to-loan-to-Mark-Antony
Corn measure	http://www.crosswordgiant.com/crossword-clue/1221804/Corn-measure
Plant's grain-bearing part	http://www.crosswordgiant.com/crossword-clue/1222797/Plants-grain-bearing-part
Musical aptitude, as it were	http://www.crosswordgiant.com/crossword-clue/1226976/Musical-aptitude-as-it-were
Organ in the heart	http://www.crosswordgiant.com/crossword-clue/1227791/Organ-in-the-heart
Drum holder	http://www.crosswordgiant.com/crossword-clue/1234620/Drum-holder
Hear here	http://www.crosswordgiant.com/crossword-clue/1236213/Hear-here
Maestro's gift	http://www.crosswordgiant.com/crossword-clue/1237154/Maestros-gift
You may eavesdrop with it	http://www.crosswordgiant.com/crossword-clue/1244328/You-may-eavesdrop-with-it
Aural aptitude	http://www.crosswordgiant.com/crossword-clue/1247828/Aural-aptitude
Where the smallest human bone is	http://www.crosswordgiant.com/crossword-clue/1248765/Where-the-smallest-human-bone-is
Place for some plugs	http://www.crosswordgiant.com/crossword-clue/1249487/Place-for-some-plugs
Hammer home	http://www.crosswordgiant.com/crossword-clue/1250089/Hammer-home
". . . silk purse out of a sow's ___"	http://www.crosswordgiant.com/crossword-clue/1251141/.-.-.-silk-purse-out-of-a-sows-___
Hearing device	http://www.crosswordgiant.com/crossword-clue/1254803/Hearing-device
Floppy feature of a basset hound	http://www.crosswordgiant.com/crossword-clue/1256505/Floppy-feature-of-a-basset-hound
It may be pierced, or just pricked	http://www.crosswordgiant.com/crossword-clue/1331412/It-may-be-pierced-or-just-pricked
Organ repairs regularly required	http://www.crosswordgiant.com/crossword-clue/1333133/Organ-repairs-regularly-required
Organ involved with balance	http://www.crosswordgiant.com/crossword-clue/1377377/Organ-involved-with-balance
Gift for music	http://www.crosswordgiant.com/crossword-clue/1408412/Gift-for-music
Big part of a hare	http://www.crosswordgiant.com/crossword-clue/1408566/Big-part-of-a-hare
Mr. Spock's had a point	http://www.crosswordgiant.com/crossword-clue/1410983/Mr.-Spocks-had-a-point
Barbecue side dish unit	http://www.crosswordgiant.com/crossword-clue/1416949/Barbecue-side-dish-unit
Van Gogh pun: ___ today, gone tomorrow?	http://www.crosswordgiant.com/crossword-clue/1419195/Van-Gogh-pun-___-today-gone-tomorrow
36 Across portion	http://www.crosswordgiant.com/crossword-clue/1422345/36-Across-portion
The listener goes on ahead	http://www.crosswordgiant.com/crossword-clue/1425410/The-listener-goes-on-ahead
Bud's beginning	http://www.crosswordgiant.com/crossword-clue/1425415/Buds-beginning
Perfect pitch organ	http://www.crosswordgiant.com/crossword-clue/1430193/Perfect-pitch-organ
Organ that's sensitive to vibrations	http://www.crosswordgiant.com/crossword-clue/1430461/Organ-thats-sensitive-to-vibrations
Hairstylist's obstacle?	http://www.crosswordgiant.com/crossword-clue/1430467/Hairstylists-obstacle
Swimmer's ___ (medical ailment)	http://www.crosswordgiant.com/crossword-clue/1431155/Swimmers-___-medical-ailment
Musician's gift?	http://www.crosswordgiant.com/crossword-clue/1433717/Musicians-gift
Mike Tyson's in-fight snack	http://www.crosswordgiant.com/crossword-clue/1444495/Mike-Tysons-in-fight-snack
Otoplasty target	http://www.crosswordgiant.com/crossword-clue/1448931/Otoplasty-target
Spot for a ring	http://www.crosswordgiant.com/crossword-clue/1449825/Spot-for-a-ring
What a headphone goes over	http://www.crosswordgiant.com/crossword-clue/1453726/What-a-headphone-goes-over
Big grin stopping point?	http://www.crosswordgiant.com/crossword-clue/1454488/Big-grin-stopping-point
Part of E.N.T	http://www.crosswordgiant.com/crossword-clue/1454498/Part-of-E.N.T
Organ with a drum inside	http://www.crosswordgiant.com/crossword-clue/1456196/Organ-with-a-drum-inside
Van Gogh's love offering	http://www.crosswordgiant.com/crossword-clue/1456450/Van-Goghs-love-offering
What a barber must cut around	http://www.crosswordgiant.com/crossword-clue/1461440/What-a-barber-must-cut-around
It helps hold glasses	http://www.crosswordgiant.com/crossword-clue/1465655/It-helps-hold-glasses
Hearing thing	http://www.crosswordgiant.com/crossword-clue/1466929/Hearing-thing
Prominent part of a basset hound	http://www.crosswordgiant.com/crossword-clue/1470463/Prominent-part-of-a-basset-hound
Knack for notes	http://www.crosswordgiant.com/crossword-clue/1475171/Knack-for-notes
Discernment of a sort	http://www.crosswordgiant.com/crossword-clue/1482335/Discernment-of-a-sort
Tin __	http://www.crosswordgiant.com/crossword-clue/1495957/Tin-__
One may play something by this	http://www.crosswordgiant.com/crossword-clue/1497420/One-may-play-something-by-this
Musicians gift?	http://www.crosswordgiant.com/crossword-clue/1498897/Musicians-gift
"You can't make a silk purse out of a sow's ___"	http://www.crosswordgiant.com/crossword-clue/1499121/You-cant-make-a-silk-purse-out-of-a-sows-___
Auditory sense	http://www.crosswordgiant.com/crossword-clue/1500806/Auditory-sense
Cauliflower __: boxing injury	http://www.crosswordgiant.com/crossword-clue/1501286/Cauliflower-__-boxing-injury
'The avenue to the heart,' per Voltaire	http://www.crosswordgiant.com/crossword-clue/1501811/The-avenue-to-the-heart-per-Voltaire
