"For shame!"	crosswordtracker.com/clue/for-shame/
Foot part	crosswordtracker.com/clue/foot-part/
Shoe part	crosswordtracker.com/clue/shoe-part/
Foot feature	crosswordtracker.com/clue/foot-feature/
Low digit	crosswordtracker.com/clue/low-digit/
Boot part	crosswordtracker.com/clue/boot-part/
Corn holder	crosswordtracker.com/clue/corn-holder/
Part of a foot	crosswordtracker.com/clue/part-of-a-foot/
Ring site	crosswordtracker.com/clue/ring-site/
Part of the foot	crosswordtracker.com/clue/part-of-the-foot/
Site for a ring	crosswordtracker.com/clue/site-for-a-ring/
Place for a ring	crosswordtracker.com/clue/place-for-a-ring/
Water tester	crosswordtracker.com/clue/water-tester/
Stocking stuffer	crosswordtracker.com/clue/stocking-stuffer-1/
Little piggy	crosswordtracker.com/clue/little-piggy/
Small digit	crosswordtracker.com/clue/small-digit/
Kind of dance	crosswordtracker.com/clue/kind-of-dance-3/
Body part	crosswordtracker.com/clue/body-part-20/
Sock part	crosswordtracker.com/clue/sock-part/
Bathwater temperature tester	crosswordtracker.com/clue/bathwater-temperature-tester/
Kind of dancer	crosswordtracker.com/clue/kind-of-dancer/
Nail site	crosswordtracker.com/clue/nail-site/
Corn site	crosswordtracker.com/clue/corn-site/
Digit	crosswordtracker.com/clue/digit-78/
Turning point?	crosswordtracker.com/clue/turning-point-3/
Low digit?	crosswordtracker.com/clue/low-digit-2/
Darned spot	crosswordtracker.com/clue/darned-spot/
Part of a sock	crosswordtracker.com/clue/part-of-a-sock/
Big __	crosswordtracker.com/clue/big-__/
Part of a shoe	crosswordtracker.com/clue/part-of-a-shoe/
Stocking stuffer?	crosswordtracker.com/clue/stocking-stuffer/
Pirouette pivot	crosswordtracker.com/clue/pirouette-pivot/
Piggy	crosswordtracker.com/clue/piggy-7/
Nail holder	crosswordtracker.com/clue/nail-holder/
Stocking's end	crosswordtracker.com/clue/stockings-end/
Bathwater tester	crosswordtracker.com/clue/bathwater-tester/
Golf-club part	crosswordtracker.com/clue/golf-club-part-1/
Little dipper?	crosswordtracker.com/clue/little-dipper/
Golf club part	crosswordtracker.com/clue/golf-club-part/
Kicker	crosswordtracker.com/clue/kicker-10/
Tip of a sock	crosswordtracker.com/clue/tip-of-a-sock/
Tip of a shoe	crosswordtracker.com/clue/tip-of-a-shoe/
Pedal digit	crosswordtracker.com/clue/pedal-digit/
Podiatrist's concern	crosswordtracker.com/clue/podiatrists-concern/
Ring bearer, maybe	crosswordtracker.com/clue/ring-bearer-maybe/
Unit smaller than a foot	crosswordtracker.com/clue/unit-smaller-than-a-foot/
Stubbing victim	crosswordtracker.com/clue/stubbing-victim/
Big or little digit	crosswordtracker.com/clue/big-or-little-digit/
Stocking part	crosswordtracker.com/clue/stocking-part/
Ballerina's pivot	crosswordtracker.com/clue/ballerinas-pivot/
Familiar tapper	crosswordtracker.com/clue/familiar-tapper/
Stubbed digit	crosswordtracker.com/clue/stubbed-digit/
Tub temperature tester	crosswordtracker.com/clue/tub-temperature-tester/
Tootsie	crosswordtracker.com/clue/tootsie/
Polish site	crosswordtracker.com/clue/polish-site/
Sock section	crosswordtracker.com/clue/sock-section/
Musician's tapper	crosswordtracker.com/clue/musicians-tapper/
Hose part	crosswordtracker.com/clue/hose-part/
Head's opposite	crosswordtracker.com/clue/heads-opposite/
Ballerina's support	crosswordtracker.com/clue/ballerinas-support/
Foot digit	crosswordtracker.com/clue/foot-digit/
The third O of OOO	crosswordtracker.com/clue/the-third-o-of-ooo/
Ballerina's perch	crosswordtracker.com/clue/ballerinas-perch/
Phalanx locale	crosswordtracker.com/clue/phalanx-locale/
Stubbed thing	crosswordtracker.com/clue/stubbed-thing/
Stocking's tip	crosswordtracker.com/clue/stockings-tip/
Tip of a wingtip	crosswordtracker.com/clue/tip-of-a-wingtip/
Kicker?	crosswordtracker.com/clue/kicker-11/
"Little piggy"	crosswordtracker.com/clue/little-piggy-4/
Get the point of	crosswordtracker.com/clue/get-the-point-of/
Kind of hold	crosswordtracker.com/clue/kind-of-hold/
Dactyl, e.g.	crosswordtracker.com/clue/dactyl-eg/
Hallux	crosswordtracker.com/clue/hallux/
Sneaker part	crosswordtracker.com/clue/sneaker-part/
It's tapped	crosswordtracker.com/clue/its-tapped-1/
Pedicure target	crosswordtracker.com/clue/pedicure-target/
Tot's "little piggie"	crosswordtracker.com/clue/tots-little-piggie/
Oft-stubbed digit	crosswordtracker.com/clue/oft-stubbed-digit/
''Little piggie''	crosswordtracker.com/clue/little-piggie/
Corn grower?	crosswordtracker.com/clue/corn-grower/
Stubbed item	crosswordtracker.com/clue/stubbed-item/
Type of hold	crosswordtracker.com/clue/type-of-hold/
Balance beam gripper	crosswordtracker.com/clue/balance-beam-gripper/
Single digit	crosswordtracker.com/clue/single-digit/
Pool temperature tester	crosswordtracker.com/clue/pool-temperature-tester/
Wing-tip tip	crosswordtracker.com/clue/wing-tip-tip/
XXX part	crosswordtracker.com/clue/xxx-part/
It may be pinched	crosswordtracker.com/clue/it-may-be-pinched/
Water temperature tester	crosswordtracker.com/clue/water-temperature-tester-1/
Corn locale	crosswordtracker.com/clue/corn-locale-1/
Boot tip	crosswordtracker.com/clue/boot-tip/
Darn site	crosswordtracker.com/clue/darn-site/
Lower digit	crosswordtracker.com/clue/lower-digit/
Part of a golf club	crosswordtracker.com/clue/part-of-a-golf-club/
Place for a nail	crosswordtracker.com/clue/place-for-a-nail/
Hoof part	crosswordtracker.com/clue/hoof-part/
Nail setting	crosswordtracker.com/clue/nail-setting/
One end of a sock	crosswordtracker.com/clue/one-end-of-a-sock/
Place for a hole in a sock	crosswordtracker.com/clue/place-for-a-hole-in-a-sock/
Nail-polish target	crosswordtracker.com/clue/nail-polish-target/
Tic-tac-__	crosswordtracker.com/clue/tic-tac-__/
__ the line (obey)	crosswordtracker.com/clue/__-the-line-obey/
One of the little piggies	crosswordtracker.com/clue/one-of-the-little-piggies/
Pirouette point	crosswordtracker.com/clue/pirouette-point/
Water tester, maybe	crosswordtracker.com/clue/water-tester-maybe/
It may test the water	crosswordtracker.com/clue/it-may-test-the-water/
It's usually first into the tub	crosswordtracker.com/clue/its-usually-first-into-the-tub/
The third of three X's	crosswordtracker.com/clue/the-third-of-three-xs/
It can be big or little	crosswordtracker.com/clue/it-can-be-big-or-little/
Tip of a wing tip	crosswordtracker.com/clue/tip-of-a-wing-tip/
Darned spot?	crosswordtracker.com/clue/darned-spot-1/
Digit that may be big	crosswordtracker.com/clue/digit-that-may-be-big/
___ loop (skater's jump)	crosswordtracker.com/clue/___-loop-skaters-jump/
Body part susceptible to frostbite	crosswordtracker.com/clue/body-part-susceptible-to-frostbite/
Little piggy, so to speak	crosswordtracker.com/clue/little-piggy-so-to-speak/
Wingtip tip	crosswordtracker.com/clue/wingtip-tip/
Bunion's place	crosswordtracker.com/clue/bunions-place/
Sandal's lack	crosswordtracker.com/clue/sandals-lack/
Stiff ballet shoe part	crosswordtracker.com/clue/stiff-ballet-shoe-part/
A minimus is the smallest one	crosswordtracker.com/clue/a-minimus-is-the-smallest-one/
Tot's "piggy"	crosswordtracker.com/clue/tots-piggy/
Tip of a boot	crosswordtracker.com/clue/tip-of-a-boot/
"Little piggie"	crosswordtracker.com/clue/little-piggie-4/
Baby's "piggy"	crosswordtracker.com/clue/babys-piggy-1/
Little digit	crosswordtracker.com/clue/little-digit-3/
Slipper part	crosswordtracker.com/clue/slipper-part/
Part of Italy	crosswordtracker.com/clue/part-of-italy-1/
Little piggy?	crosswordtracker.com/clue/little-piggy-7/
Winning X or O	crosswordtracker.com/clue/winning-x-or-o/
Tot's "little piggy"	crosswordtracker.com/clue/tots-little-piggy/
Dactyl or hallux	crosswordtracker.com/clue/dactyl-or-hallux/
Drive a nail obliquely	crosswordtracker.com/clue/drive-a-nail-obliquely/
Piggie	crosswordtracker.com/clue/piggie-6/
Hallux or dactyl	crosswordtracker.com/clue/hallux-or-dactyl/
It's sometimes stubbed	crosswordtracker.com/clue/its-sometimes-stubbed/
Turf ___ (football player's malady)	crosswordtracker.com/clue/turf-___-football-players-malady/
Temperature tester	crosswordtracker.com/clue/temperature-tester/
Tick tack follower	crosswordtracker.com/clue/tick-tack-follower/
It's first into the tub	crosswordtracker.com/clue/its-first-into-the-tub/
Nailed item	crosswordtracker.com/clue/nailed-item/
End of a golf club	crosswordtracker.com/clue/end-of-a-golf-club/
One may be stubbed	crosswordtracker.com/clue/one-may-be-stubbed/
"Little piggy," in a children's rhyme	crosswordtracker.com/clue/little-piggy-in-a-childrens-rhyme/
Word with ''hold'' or ''nail''	crosswordtracker.com/clue/word-with-hold-or-nail/
__ the line: conform	crosswordtracker.com/clue/__-the-line-conform/
Wingtip section	crosswordtracker.com/clue/wingtip-section/
First thing in the water, usually	crosswordtracker.com/clue/first-thing-in-the-water-usually/
Lou "The __" Groza, memorable NFL placekicker	crosswordtracker.com/clue/lou-the-__-groza-memorable-nfl-placekicker/
Last of three X's	crosswordtracker.com/clue/last-of-three-xs/
Crude thermometer in the pool?	crosswordtracker.com/clue/crude-thermometer-in-the-pool/
Winning X	crosswordtracker.com/clue/winning-x/
__ the line	crosswordtracker.com/clue/__-the-line/
Big and little digit	crosswordtracker.com/clue/big-and-little-digit/
Terminal digit	crosswordtracker.com/clue/terminal-digit/
Tot's ''little piggie''	crosswordtracker.com/clue/tots-little-piggie-1/
One O of OOO	crosswordtracker.com/clue/one-o-of-ooo/
Foot ending	crosswordtracker.com/clue/foot-ending/
Beat tapper	crosswordtracker.com/clue/beat-tapper/
Head opposite	crosswordtracker.com/clue/head-opposite/
Tapper, at times	crosswordtracker.com/clue/tapper-at-times/
Water-temperature tester	crosswordtracker.com/clue/water-temperature-tester/
Word with hold or nail	crosswordtracker.com/clue/word-with-hold-or-nail-1/
Gout target, often	crosswordtracker.com/clue/gout-target-often/
Water-temperature gauge	crosswordtracker.com/clue/water-temperature-gauge/
Pedal part	crosswordtracker.com/clue/pedal-part/
Polish target, perhaps	crosswordtracker.com/clue/polish-target-perhaps/
Third X in a game	crosswordtracker.com/clue/third-x-in-a-game/
Sight in a sandal	crosswordtracker.com/clue/sight-in-a-sandal/
Bad dancer's target	crosswordtracker.com/clue/bad-dancers-target/
Foot feature with phalanges	crosswordtracker.com/clue/foot-feature-with-phalanges/
Piggy, to a tot	crosswordtracker.com/clue/piggy-to-a-tot/
Talon's location	crosswordtracker.com/clue/talons-location/
"This little piggy ..." digit	crosswordtracker.com/clue/this-little-piggy-digit/
Spot for a nail	crosswordtracker.com/clue/spot-for-a-nail/
Water temperature gauge, sometimes	crosswordtracker.com/clue/water-temperature-gauge-sometimes/
Certain limb's end	crosswordtracker.com/clue/certain-limbs-end/
Kicker's digit?	crosswordtracker.com/clue/kickers-digit/
Oft-tapped item	crosswordtracker.com/clue/oft-tapped-item/
Piggy who went to market, e.g.	crosswordtracker.com/clue/piggy-who-went-to-market-eg/
Foot end	crosswordtracker.com/clue/foot-end-1/
Baby's ''piggy''	crosswordtracker.com/clue/babys-piggy/
Piggy, e.g.	crosswordtracker.com/clue/piggy-eg/
Occasional tapper	crosswordtracker.com/clue/occasional-tapper/
Minimus, e.g.	crosswordtracker.com/clue/minimus-eg/
Last O of O-O-O	crosswordtracker.com/clue/last-o-of-o-o-o/
Nether digit	crosswordtracker.com/clue/nether-digit/
Lower extremity	crosswordtracker.com/clue/lower-extremity/
The winning X	crosswordtracker.com/clue/the-winning-x/
Pirouette pivot point	crosswordtracker.com/clue/pirouette-pivot-point-1/
Place for polish, perhaps	crosswordtracker.com/clue/place-for-polish-perhaps/
It may have a painted nail	crosswordtracker.com/clue/it-may-have-a-painted-nail/
Piggy, of a sort	crosswordtracker.com/clue/piggy-of-a-sort/
Ring site, perhaps	crosswordtracker.com/clue/ring-site-perhaps/
Ballet pivot	crosswordtracker.com/clue/ballet-pivot/
Water-testing digit	crosswordtracker.com/clue/water-testing-digit/
___ the line (obey)	crosswordtracker.com/clue/___-the-line-obey/
Sock tip	crosswordtracker.com/clue/sock-tip/
Sock's end	crosswordtracker.com/clue/socks-end/
"The __": placekicker Lou Groza's nickname	crosswordtracker.com/clue/the-__-placekicker-lou-grozas-nickname/
Piggy, to a kiddy	crosswordtracker.com/clue/piggy-to-a-kiddy/
Polish place, perhaps	crosswordtracker.com/clue/polish-place-perhaps/
"Piggy"	crosswordtracker.com/clue/piggy-18/
It's often pointed in gymnastics	crosswordtracker.com/clue/its-often-pointed-in-gymnastics/
One on the Statue of Liberty is almost three feet long	crosswordtracker.com/clue/one-on-the-statue-of-liberty-is-almost-three-feet-long/
It may provide one's sole support	crosswordtracker.com/clue/it-may-provide-ones-sole-support/
Important part for a jig	crosswordtracker.com/clue/important-part-for-a-jig/
Boot feature	crosswordtracker.com/clue/boot-feature/
Chipped part of a statue, maybe	crosswordtracker.com/clue/chipped-part-of-a-statue-maybe/
___ loop (skating move)	crosswordtracker.com/clue/___-loop-skating-move/
Nail spot	crosswordtracker.com/clue/nail-spot/
Place for a Dr. Scholl's pad	crosswordtracker.com/clue/place-for-a-dr-scholls-pad/
Place for polish	crosswordtracker.com/clue/place-for-polish-1/
Corn grower	crosswordtracker.com/clue/corn-grower-1/
Foot's end	crosswordtracker.com/clue/foots-end/
Shoe's end	crosswordtracker.com/clue/shoes-end/
One little piggy	crosswordtracker.com/clue/one-little-piggy-1/
Pirouetter's pivot	crosswordtracker.com/clue/pirouetters-pivot/
Ballerina's digit	crosswordtracker.com/clue/ballerinas-digit/
Corn location	crosswordtracker.com/clue/corn-location/
Part of a pair of tights	crosswordtracker.com/clue/part-of-a-pair-of-tights/
Limb's end	crosswordtracker.com/clue/limbs-end/
Water temperature gauge	crosswordtracker.com/clue/water-temperature-gauge-2/
Common gout site	crosswordtracker.com/clue/common-gout-site/
Part of Italy where Cape Spartivento is	crosswordtracker.com/clue/part-of-italy-where-cape-spartivento-is/
Water temperature gauge?	crosswordtracker.com/clue/water-temperature-gauge-3/
Tip of a mule	crosswordtracker.com/clue/tip-of-a-mule/
Third X, in a simple game	crosswordtracker.com/clue/third-x-in-a-simple-game/
Swimming pool tester	crosswordtracker.com/clue/swimming-pool-tester/
Ballerina's pivot point	crosswordtracker.com/clue/ballerinas-pivot-point/
One of the 10 lowest digits?	crosswordtracker.com/clue/one-of-the-10-lowest-digits/
Ungulate's hoof, essentially	crosswordtracker.com/clue/ungulates-hoof-essentially/
Sock or foot part	crosswordtracker.com/clue/sock-or-foot-part/
Body part that can be stubbed	crosswordtracker.com/clue/body-part-that-can-be-stubbed/
It may be painted	crosswordtracker.com/clue/it-may-be-painted-1/
Shoe tip	crosswordtracker.com/clue/shoe-tip-1/
Stubbed extremity	crosswordtracker.com/clue/stubbed-extremity/
It may be tapped at a concert	crosswordtracker.com/clue/it-may-be-tapped-at-a-concert/
Sub-unit of a foot	crosswordtracker.com/clue/sub-unit-of-a-foot/
Ballerina's balancing point	crosswordtracker.com/clue/ballerinas-balancing-point/
Follower of tic-tac	crosswordtracker.com/clue/follower-of-tic-tac/
Crude pool thermometer?	crosswordtracker.com/clue/crude-pool-thermometer/
Oft-stubbed extremity	crosswordtracker.com/clue/oft-stubbed-extremity/
Turf ___ (gridder's malady)	crosswordtracker.com/clue/turf-___-gridders-malady/
__ clip (bike part)	crosswordtracker.com/clue/__-clip-bike-part/
Turf __: common football injury	crosswordtracker.com/clue/turf-__-common-football-injury/
Last X of X-X-X	crosswordtracker.com/clue/last-x-of-x-x-x/
Place for a ring, perhaps	crosswordtracker.com/clue/place-for-a-ring-perhaps/
It may be corny	crosswordtracker.com/clue/it-may-be-corny/
Gymnast's pointed part	crosswordtracker.com/clue/gymnasts-pointed-part/
Dactyl	crosswordtracker.com/clue/dactyl-1/
Common darning spot	crosswordtracker.com/clue/common-darning-spot/
Bunions place	crosswordtracker.com/clue/bunions-place-1/
It may be stubbed	crosswordtracker.com/clue/it-may-be-stubbed/
Digital feature	crosswordtracker.com/clue/digital-feature/
Big digit	crosswordtracker.com/clue/big-digit/
Big or little dipper	crosswordtracker.com/clue/big-or-little-dipper/
Tip for a ballerina	crosswordtracker.com/clue/tip-for-a-ballerina/
Bath water tester	crosswordtracker.com/clue/bath-water-tester/
Digit with a ring, maybe	crosswordtracker.com/clue/digit-with-a-ring-maybe/
Gout spot	crosswordtracker.com/clue/gout-spot/
Time keeper, at times	crosswordtracker.com/clue/time-keeper-at-times/
Italy's bottom	crosswordtracker.com/clue/italys-bottom/
Shoe part that may pinch	crosswordtracker.com/clue/shoe-part-that-may-pinch/
It may test the waters	crosswordtracker.com/clue/it-may-test-the-waters/
Third X	crosswordtracker.com/clue/third-x-2/
Third X or O	crosswordtracker.com/clue/third-x-or-o/
Nursery "piggy"	crosswordtracker.com/clue/nursery-piggy/
Tip trailer	crosswordtracker.com/clue/tip-trailer/
Pointe balancing point	crosswordtracker.com/clue/pointe-balancing-point/
Tip-___	crosswordtracker.com/clue/tip-___/
Southern Italy area	crosswordtracker.com/clue/southern-italy-area/
Hallux, e.g.	crosswordtracker.com/clue/hallux-eg/
Tic-tac follower	crosswordtracker.com/clue/tic-tac-follower/
Little corn grower	crosswordtracker.com/clue/little-corn-grower/
Podagra afflicts it	crosswordtracker.com/clue/podagra-afflicts-it/
Nail aslant	crosswordtracker.com/clue/nail-aslant/
Part of Italy on a map	crosswordtracker.com/clue/part-of-italy-on-a-map/
Punter's asset	crosswordtracker.com/clue/punters-asset/
It's stubbed	crosswordtracker.com/clue/its-stubbed/
Ballet dancer's digit	crosswordtracker.com/clue/ballet-dancers-digit/
Kicker's asset	crosswordtracker.com/clue/kickers-asset/
___ the line (conform)	crosswordtracker.com/clue/___-the-line-conform-1/
Little piggie	crosswordtracker.com/clue/little-piggie-5/
Angle a nail	crosswordtracker.com/clue/angle-a-nail/
Ballet point	crosswordtracker.com/clue/ballet-point/
Hammer at an angle	crosswordtracker.com/clue/hammer-at-an-angle/
Pedicured item	crosswordtracker.com/clue/pedicured-item/
___ the mark	crosswordtracker.com/clue/___-the-mark/
Reggio's locale in Italy	crosswordtracker.com/clue/reggios-locale-in-italy/
It's often stubbed	crosswordtracker.com/clue/its-often-stubbed/
Small corn grower	crosswordtracker.com/clue/small-corn-grower/
An area of Italy	crosswordtracker.com/clue/an-area-of-italy/
Place for a callus	crosswordtracker.com/clue/place-for-a-callus/
Corn spot	crosswordtracker.com/clue/corn-spot/
Nail's place	crosswordtracker.com/clue/nails-place/
Ledge grabber	crosswordtracker.com/clue/ledge-grabber/
Final X, maybe	crosswordtracker.com/clue/final-x-maybe/
Footsie player?	crosswordtracker.com/clue/footsie-player/
Tic-tac-___	crosswordtracker.com/clue/tic-tac-___/
Bunion's locale	crosswordtracker.com/clue/bunions-locale/
Bathtime tester	crosswordtracker.com/clue/bathtime-tester/
Big or little follower	crosswordtracker.com/clue/big-or-little-follower/
AKA Hector (Blake)	crosswordtracker.com/clue/aka-hector-blake/
Nail or loop preceder	crosswordtracker.com/clue/nail-or-loop-preceder/
Little piggy, in a tot's rhyme	crosswordtracker.com/clue/little-piggy-in-a-tots-rhyme/
Nail locale	crosswordtracker.com/clue/nail-locale/
Wing tip part	crosswordtracker.com/clue/wing-tip-part/
Bath-water tester	crosswordtracker.com/clue/bath-water-tester-1/
Unit smaller than a foot?	crosswordtracker.com/clue/unit-smaller-than-a-foot-1/
Golf club head part	crosswordtracker.com/clue/golf-club-head-part/
Piggy who went to market	crosswordtracker.com/clue/piggy-who-went-to-market-1/
Pool water tester	crosswordtracker.com/clue/pool-water-tester-1/
Big or baby, e.g.	crosswordtracker.com/clue/big-or-baby-eg/
--- the line	crosswordtracker.com/clue/-the-line/
Pool tester	crosswordtracker.com/clue/pool-tester/
Darn site, perhaps	crosswordtracker.com/clue/darn-site-perhaps/
Turning point for Pavlova?	crosswordtracker.com/clue/turning-point-for-pavlova/
Pavlova's turning point?	crosswordtracker.com/clue/pavlovas-turning-point/
Punt propeller?	crosswordtracker.com/clue/punt-propeller-1/
"--- the line!"	crosswordtracker.com/clue/-the-line-1/
Tap it	crosswordtracker.com/clue/tap-it/
"___ the line!"	crosswordtracker.com/clue/___-the-line-10/
Hammer in obliquely	crosswordtracker.com/clue/hammer-in-obliquely/
Ballerina's asset	crosswordtracker.com/clue/ballerinas-asset-1/
Bunion site	crosswordtracker.com/clue/bunion-site/
It's nailed	crosswordtracker.com/clue/its-nailed/
Corn setting	crosswordtracker.com/clue/corn-setting/
Shoe's tip	crosswordtracker.com/clue/shoes-tip/
Pavlova's pivot	crosswordtracker.com/clue/pavlovas-pivot/
Third X, in a game	crosswordtracker.com/clue/third-x-in-a-game-1/
Shoe end	crosswordtracker.com/clue/shoe-end-2/
Shoe front	crosswordtracker.com/clue/shoe-front-1/
Obey, with "the line"	crosswordtracker.com/clue/obey-with-the-line/
Big ___ (body part)	crosswordtracker.com/clue/big-___-body-part/
Word after big, middle, or little	crosswordtracker.com/clue/word-after-big-middle-or-little/
Pivot point when en pointe	crosswordtracker.com/clue/pivot-point-when-en-pointe/
Boot part	crosswordheaven.com/clues/boot-part
Part of Italy	crosswordheaven.com/clues/part-of-italy
Water tester	crosswordheaven.com/clues/water-tester
Nail site	crosswordheaven.com/clues/nail-site
Place for a hole in a sock	crosswordheaven.com/clues/place-for-a-hole-in-a-sock
Familiar tapper	crosswordheaven.com/clues/familiar-tapper
Shoe part	crosswordheaven.com/clues/shoe-part
Corn site	crosswordheaven.com/clues/corn-site
Time keeper, at times	crosswordheaven.com/clues/time-keeper-at-times
Gout spot	crosswordheaven.com/clues/gout-spot
Little piggy?	crosswordheaven.com/clues/little-piggy
Pirouette point	crosswordheaven.com/clues/pirouette-point
Water tester, maybe	crosswordheaven.com/clues/water-tester-maybe
Stocking part	crosswordheaven.com/clues/stocking-part
Bathwater tester	crosswordheaven.com/clues/bathwater-tester
Italy's bottom	crosswordheaven.com/clues/italys-bottom
Stocking's end	crosswordheaven.com/clues/stockings-end
___ loop (skater's jump)	crosswordheaven.com/clues/___-loop-skaters-jump
Shoe part that may pinch	crosswordheaven.com/clues/shoe-part-that-may-pinch
Darn site	crosswordheaven.com/clues/darn-site
It may test the waters	crosswordheaven.com/clues/it-may-test-the-waters
Third X	crosswordheaven.com/clues/third-x
Last third of a game with nine boxes	crosswordheaven.com/clues/last-third-of-a-game-with-nine-boxes
See 70-Down	crosswordheaven.com/clues/see-70-down
Last X of X-X-X	crosswordheaven.com/clues/last-x-of-x-x-x
Place for a ring, perhaps	crosswordheaven.com/clues/place-for-a-ring-perhaps
Little piggy	crosswordheaven.com/clues/little-piggy
Kicker?	crosswordheaven.com/clues/kicker
A minimus is the smallest one	crosswordheaven.com/clues/a-minimus-is-the-smallest-one
Gymnast's pointed part	crosswordheaven.com/clues/gymnasts-pointed-part
It may be corny	crosswordheaven.com/clues/it-may-be-corny
Toddler's "little piggy"	crosswordheaven.com/clues/toddlers-little-piggy
Low digit?	crosswordheaven.com/clues/low-digit
Pool temperature tester	crosswordheaven.com/clues/pool-temperature-tester
Balance beam gripper	crosswordheaven.com/clues/balance-beam-gripper
Dactyl	crosswordheaven.com/clues/dactyl
Water temperature tester	crosswordheaven.com/clues/water-temperature-tester
Hoof part	crosswordheaven.com/clues/hoof-part
Nail holder	crosswordheaven.com/clues/nail-holder
Bunion’s place	crosswordheaven.com/clues/bunions-place
Common darning spot	crosswordheaven.com/clues/common-darning-spot
Piggy	crosswordheaven.com/clues/piggy
Hose part	crosswordheaven.com/clues/hose-part
Wing-tip tip	crosswordheaven.com/clues/wing-tip-tip
Unit smaller than a foot	crosswordheaven.com/clues/unit-smaller-than-a-foot
Turning point?	crosswordheaven.com/clues/turning-point
Pedal digit	crosswordheaven.com/clues/pedal-digit
Stubbed item	crosswordheaven.com/clues/stubbed-item
See 28-Across	crosswordheaven.com/clues/see-28-across
Low digit	crosswordheaven.com/clues/low-digit
It may be stubbed	crosswordheaven.com/clues/it-may-be-stubbed
Digital feature	crosswordheaven.com/clues/digital-feature
Sock part	crosswordheaven.com/clues/sock-part
Bunion locale	crosswordheaven.com/clues/bunion-locale
Big digit	crosswordheaven.com/clues/big-digit
Kind of hold	crosswordheaven.com/clues/kind-of-hold
Tip for a ballerina	crosswordheaven.com/clues/tip-for-a-ballerina
Big or little dipper	crosswordheaven.com/clues/big-or-little-dipper
Bath water tester	crosswordheaven.com/clues/bath-water-tester
Corn location	crosswordheaven.com/clues/corn-location
Part of a pair of tights	crosswordheaven.com/clues/part-of-a-pair-of-tights
Limb's end	crosswordheaven.com/clues/limbs-end
Water temperature gauge	crosswordheaven.com/clues/water-temperature-gauge
Bunion's place	crosswordheaven.com/clues/bunions-place
Stubbed thing	crosswordheaven.com/clues/stubbed-thing
Stocking stuffer?	crosswordheaven.com/clues/stocking-stuffer
Corn grower	crosswordheaven.com/clues/corn-grower
Foot's end	crosswordheaven.com/clues/foots-end
Head's opposite	crosswordheaven.com/clues/heads-opposite
Shoe's end	crosswordheaven.com/clues/shoes-end
One little piggy	crosswordheaven.com/clues/one-little-piggy
Pirouetter's pivot	crosswordheaven.com/clues/pirouetters-pivot
Wingtip tip	crosswordheaven.com/clues/wingtip-tip
Sandal's lack	crosswordheaven.com/clues/sandals-lack
Ballerina's digit	crosswordheaven.com/clues/ballerinas-digit
Small digit	crosswordheaven.com/clues/small-digit
"Little piggy"	crosswordheaven.com/clues/little-piggy
Stocking's tip	crosswordheaven.com/clues/stockings-tip
Pirouette pivot	crosswordheaven.com/clues/pirouette-pivot
Place for polish	crosswordheaven.com/clues/place-for-polish
Place for a Dr. Scholl's pad	crosswordheaven.com/clues/place-for-a-dr-scholls-pad
It may be pinched	crosswordheaven.com/clues/it-may-be-pinched
Corn locale	crosswordheaven.com/clues/corn-locale
Tip of a wingtip	crosswordheaven.com/clues/tip-of-a-wingtip
Golf club part	crosswordheaven.com/clues/golf-club-part
It may provide one's sole support	crosswordheaven.com/clues/it-may-provide-ones-sole-support
Important part for a jig	crosswordheaven.com/clues/important-part-for-a-jig
46-Across part	crosswordheaven.com/clues/46-across-part
Tot's "piggy"	crosswordheaven.com/clues/tots-piggy
Boot feature	crosswordheaven.com/clues/boot-feature
Swimming pool tester	crosswordheaven.com/clues/swimming-pool-tester
Shoe end	crosswordheaven.com/clues/shoe-end
Darned spot	crosswordheaven.com/clues/darned-spot
Pedicure target	crosswordheaven.com/clues/pedicure-target
Baby's "piggy"	crosswordheaven.com/clues/babys-piggy
Toddler's piggy	crosswordheaven.com/clues/toddlers-piggy
Part of Italy?	crosswordheaven.com/clues/part-of-italy
Head's antithesis	crosswordheaven.com/clues/heads-antithesis
Wing tip's tip	crosswordheaven.com/clues/wing-tips-tip
Single digit	crosswordheaven.com/clues/single-digit
Ballerina's balancing point	crosswordheaven.com/clues/ballerinas-balancing-point
Tip of a wing tip	crosswordheaven.com/clues/tip-of-a-wing-tip
"Piggy" on a tot's foot	crosswordheaven.com/clues/piggy-on-a-tots-foot
Corn-growing location	crosswordheaven.com/clues/corn-growing-location
___ the line	crosswordheaven.com/clues/___-the-line
___ pick (figure skate part)	crosswordheaven.com/clues/___-pick-figure-skate-part
Little piggy, maybe	crosswordheaven.com/clues/little-piggy-maybe
One of a rhino's 12	crosswordheaven.com/clues/one-of-a-rhinos-12
Water temperature "gauge"	crosswordheaven.com/clues/water-temperature-gauge
Wingtip's tip	crosswordheaven.com/clues/wingtips-tip
It tests the waters	crosswordheaven.com/clues/it-tests-the-waters
Piggy, in a nursery rhyme	crosswordheaven.com/clues/piggy-in-a-nursery-rhyme
Piggy in a child's nursery rhyme	crosswordheaven.com/clues/piggy-in-a-childs-nursery-rhyme
It may test the water	crosswordheaven.com/clues/it-may-test-the-water
Ballerina's support	crosswordheaven.com/clues/ballerinas-support
Foot digit	crosswordheaven.com/clues/foot-digit
Stocking stuffer	crosswordheaven.com/clues/stocking-stuffer
Foot part	crosswordheaven.com/clues/foot-part
"This little piggy ..." digit	crosswordheaven.com/clues/this-little-piggy-digit
Piggy, to a tot	crosswordheaven.com/clues/piggy-to-a-tot
Talon's location	crosswordheaven.com/clues/talons-location
Ballerina's pivot	crosswordheaven.com/clues/ballerinas-pivot
Stubbing victim	crosswordheaven.com/clues/stubbing-victim
The third of three X's	crosswordheaven.com/clues/the-third-of-three-xs
Corn spot	crosswordheaven.com/clues/corn-spot
Chipped part of a statue, maybe	crosswordheaven.com/clues/chipped-part-of-a-statue-maybe
___ loop (skating move)	crosswordheaven.com/clues/___-loop-skating-move
Nail spot	crosswordheaven.com/clues/nail-spot
The third O of OOO	crosswordheaven.com/clues/the-third-o-of-ooo
It's sometimes stubbed	crosswordheaven.com/clues/its-sometimes-stubbed
Ring bearer, maybe	crosswordheaven.com/clues/ring-bearer-maybe
Nail's place	crosswordheaven.com/clues/nails-place
Ledge grabber	crosswordheaven.com/clues/ledge-grabber
Final X, maybe	crosswordheaven.com/clues/final-x-maybe
Boot tip	crosswordheaven.com/clues/boot-tip
Footsie player?	crosswordheaven.com/clues/footsie-player
The winning X	crosswordheaven.com/clues/the-winning-x
Crude thermometer in the pool?	crosswordheaven.com/clues/crude-thermometer-in-the-pool
Place for a ring	crosswordheaven.com/clues/place-for-a-ring
__ the line	crosswordheaven.com/clues/__-the-line
Ring site	crosswordheaven.com/clues/ring-site
Nail setting	crosswordheaven.com/clues/nail-setting
__ the line: conform	crosswordheaven.com/clues/__-the-line-conform
First thing in the water, usually	crosswordheaven.com/clues/first-thing-in-the-water-usually
Lou "The __" Groza, memorable NFL placekicker	crosswordheaven.com/clues/lou-the-__-groza-memorable-nfl-placekicker
Oft-stubbed digit	crosswordheaven.com/clues/oft-stubbed-digit
Terminal digit	crosswordheaven.com/clues/terminal-digit
Podiatrist's concern	crosswordheaven.com/clues/podiatrists-concern
One of the little piggies	crosswordheaven.com/clues/one-of-the-little-piggies
Beat tapper	crosswordheaven.com/clues/beat-tapper
Tapper, at times	crosswordheaven.com/clues/tapper-at-times
Nail locale	crosswordheaven.com/clues/nail-locale
Little piggy, in a tot's rhyme	crosswordheaven.com/clues/little-piggy-in-a-tots-rhyme
__ the line (obey)	crosswordheaven.com/clues/__-the-line-obey
Water-temperature tester	crosswordheaven.com/clues/water-temperature-tester
Part of a sock	crosswordheaven.com/clues/part-of-a-sock
Water-temperature gauge	crosswordheaven.com/clues/water-temperature-gauge
Pedal part	crosswordheaven.com/clues/pedal-part
Polish target, perhaps	crosswordheaven.com/clues/polish-target-perhaps
Golf-club part	crosswordheaven.com/clues/golf-club-part
''Little piggie''	crosswordheaven.com/clues/little-piggie
Part of a shoe	crosswordheaven.com/clues/part-of-a-shoe
Tot's ''little piggie''	crosswordheaven.com/clues/tots-little-piggie
Foot ending	crosswordheaven.com/clues/foot-ending
Part of a foot	crosswordheaven.com/clues/part-of-a-foot
Part of the foot	crosswordheaven.com/clues/part-of-the-foot
Tip of a sock	crosswordheaven.com/clues/tip-of-a-sock
One end of a sock	crosswordheaven.com/clues/one-end-of-a-sock
Nail-polish target	crosswordheaven.com/clues/nail-polish-target
Polish site	crosswordheaven.com/clues/polish-site
Tic-tac-__	crosswordheaven.com/clues/tic-tac-__
Big __	crosswordheaven.com/clues/big-__
Tip of a shoe	crosswordheaven.com/clues/tip-of-a-shoe
Swimming-pool tester	crosswordheaven.com/clues/swimming-pool-tester
Minimus, e.g.	crosswordheaven.com/clues/minimus-eg
Last O of O-O-O	crosswordheaven.com/clues/last-o-of-o-o-o
Nether digit	crosswordheaven.com/clues/nether-digit
Lower extremity	crosswordheaven.com/clues/lower-extremity
Digit that may be big	crosswordheaven.com/clues/digit-that-may-be-big
Sock section	crosswordheaven.com/clues/sock-section
Occasional tapper	crosswordheaven.com/clues/occasional-tapper
Piggy who went to market, e.g.	crosswordheaven.com/clues/piggy-who-went-to-market-eg
Foot end	crosswordheaven.com/clues/foot-end
Darned spot?	crosswordheaven.com/clues/darned-spot
Ballerina's perch	crosswordheaven.com/clues/ballerinas-perch
Big or little digit	crosswordheaven.com/clues/big-or-little-digit
Type of hold	crosswordheaven.com/clues/type-of-hold
Baby's ''piggy''	crosswordheaven.com/clues/babys-piggy
Phalanx locale	crosswordheaven.com/clues/phalanx-locale
Piggy, e.g.	crosswordheaven.com/clues/piggy-eg
Kicker's digit?	crosswordheaven.com/clues/kickers-digit
It can be big or little	crosswordheaven.com/clues/it-can-be-big-or-little
Oft-tapped item	crosswordheaven.com/clues/oft-tapped-item
Body part susceptible to frostbite	crosswordheaven.com/clues/body-part-susceptible-to-frostbite
Big and little digit	crosswordheaven.com/clues/big-and-little-digit
Winning X	crosswordheaven.com/clues/winning-x
It can be painful when corny	crosswordheaven.com/clues/it-can-be-painful-when-corny
Word with "hold" or "nail"	crosswordheaven.com/clues/word-with-hold-or-nail
Word with "tapper"	crosswordheaven.com/clues/word-with-tapper
Wingtip section	crosswordheaven.com/clues/wingtip-section
Last of three X's	crosswordheaven.com/clues/last-of-three-xs
One O of OOO	crosswordheaven.com/clues/one-o-of-ooo
The end of Italy, shapewise	crosswordheaven.com/clues/the-end-of-italy-shapewise
Head opposite	crosswordheaven.com/clues/head-opposite
Word with hold or nail	crosswordheaven.com/clues/word-with-hold-or-nail
Gout target, often	crosswordheaven.com/clues/gout-target-often
Digit	crosswordheaven.com/clues/digit
Golf club head part	crosswordheaven.com/clues/golf-club-head-part
Piggy who went to market	crosswordheaven.com/clues/piggy-who-went-to-market
Bath-water tester	crosswordheaven.com/clues/bath-water-tester
Unit smaller than a foot?	crosswordheaven.com/clues/unit-smaller-than-a-foot
Wing tip part	crosswordheaven.com/clues/wing-tip-part
Third X in a game	crosswordheaven.com/clues/third-x-in-a-game
"Piggy"	crosswordheaven.com/clues/piggy
Pirouette pivot point	crosswordheaven.com/clues/pirouette-pivot-point
Tot's "little piggie"	crosswordheaven.com/clues/tots-little-piggie
Sight in a sandal	crosswordheaven.com/clues/sight-in-a-sandal
Place for polish, perhaps	crosswordheaven.com/clues/place-for-polish-perhaps
Little piggy, so to speak	crosswordheaven.com/clues/little-piggy-so-to-speak
It may have a painted nail	crosswordheaven.com/clues/it-may-have-a-painted-nail
Piggy, of a sort	crosswordheaven.com/clues/piggy-of-a-sort
Ring site, perhaps	crosswordheaven.com/clues/ring-site-perhaps
Ballet pivot	crosswordheaven.com/clues/ballet-pivot
Water-testing digit	crosswordheaven.com/clues/water-testing-digit
Stiff ballet shoe part	crosswordheaven.com/clues/stiff-ballet-shoe-part
___ the line (obey)	crosswordheaven.com/clues/___-the-line-obey
Big ___	crosswordheaven.com/clues/big-___
Sock tip	crosswordheaven.com/clues/sock-tip
It's often pointed in gymnastics	crosswordheaven.com/clues/its-often-pointed-in-gymnastics
Sock's end	crosswordheaven.com/clues/socks-end
"The __": placekicker Lou Groza's nickname	crosswordheaven.com/clues/the-__-placekicker-lou-grozas-nickname
Little dipper?	crosswordheaven.com/clues/little-dipper
Piggy, to a kiddy	crosswordheaven.com/clues/piggy-to-a-kiddy
It's usually first into the tub	crosswordheaven.com/clues/its-usually-first-into-the-tub
One on the Statue of Liberty is almost three feet long	crosswordheaven.com/clues/one-on-the-statue-of-liberty-is-almost-three-feet-long
Polish place, perhaps	crosswordheaven.com/clues/polish-place-perhaps
Tip of a boot	crosswordheaven.com/clues/tip-of-a-boot
XXX part	crosswordheaven.com/clues/xxx-part
Stubbed digit	crosswordheaven.com/clues/stubbed-digit
Get the point of	crosswordheaven.com/clues/get-the-point-of
Common gout site	crosswordheaven.com/clues/common-gout-site
Part of Italy where Cape Spartivento is	crosswordheaven.com/clues/part-of-italy-where-cape-spartivento-is
Water temperature gauge?	crosswordheaven.com/clues/water-temperature-gauge
Tip of a mule	crosswordheaven.com/clues/tip-of-a-mule
Third X, in a simple game	crosswordheaven.com/clues/third-x-in-a-simple-game
Bunions place	crosswordheaven.com/clues/bunions-place
___ the line: conform	crosswordheaven.com/clues/___-the-line-conform
Lou "The ___" Groza, memorable NFL placekicker	crosswordheaven.com/clues/lou-the-___-groza-memorable-nfl-placekicker
"The ___": placekicker Lou Groza's nickname	crosswordheaven.com/clues/the-___-placekicker-lou-grozas-nickname
Foot feature with phalanges	crosswordheaven.com/clues/foot-feature-with-phalanges
Corn grower?	crosswordheaven.com/clues/corn-grower
Bad dancer's target	crosswordheaven.com/clues/bad-dancers-target
Musician's tapper	crosswordheaven.com/clues/musicians-tapper
"Little piggie"	crosswordheaven.com/clues/little-piggie
Tic-tac-___	crosswordheaven.com/clues/tic-tac-___
Pavlova's pivot	crosswordheaven.com/clues/pavlovas-pivot
Bathwater temperature tester	crosswordheaven.com/clues/bathwater-temperature-tester
Word after big, middle, or little	crosswordheaven.com/clues/word-after-big-middle-or-little
Ballerina's pivot point	crosswordheaven.com/clues/ballerinas-pivot-point
One of the 10 lowest digits?	crosswordheaven.com/clues/one-of-the-10-lowest-digits
Oxford leader?	crosswordheaven.com/clues/oxford-leader
Big or little follower	crosswordheaven.com/clues/big-or-little-follower
Foot feature	crosswordheaven.com/clues/foot-feature
Nail or loop preceder	crosswordheaven.com/clues/nail-or-loop-preceder
Ungulate's hoof, essentially	crosswordheaven.com/clues/ungulates-hoof-essentially
Sock or foot part	crosswordheaven.com/clues/sock-or-foot-part
Body part that can be stubbed	crosswordheaven.com/clues/body-part-that-can-be-stubbed
Shoe front	crosswordheaven.com/clues/shoe-front
Tub temperature tester	crosswordheaven.com/clues/tub-temperature-tester
Body part	crosswordheaven.com/clues/body-part
It may be painted	crosswordheaven.com/clues/it-may-be-painted
Pedicurist's target(3)	crosswordheaven.com/clues/pedicurists-target3
Shoe tip	crosswordheaven.com/clues/shoe-tip
Stubbed extremity	crosswordheaven.com/clues/stubbed-extremity
It may be tapped at a concert	crosswordheaven.com/clues/it-may-be-tapped-at-a-concert
Pivot point when en pointe	crosswordheaven.com/clues/pivot-point-when-en-pointe
Sub-unit of a foot	crosswordheaven.com/clues/sub-unit-of-a-foot
Digit that's sometimes stubbed	crosswordheaven.com/clues/digit-thats-sometimes-stubbed
Pump part	crosswordheaven.com/clues/pump-part
Pump part	crosswordheaven.com/clues/pump-part
Stub hub?	crosswordheaven.com/clues/stub-hub
Site for a ring	crosswordheaven.com/clues/site-for-a-ring
Little wiggler	crosswordheaven.com/clues/little-wiggler
Follower of tic-tac	crosswordheaven.com/clues/follower-of-tic-tac
Bunion spot	crosswordheaven.com/clues/bunion-spot
Sandal sight	crosswordheaven.com/clues/sandal-sight
Loafer part	crosswordheaven.com/clues/loafer-part
Corn setting	crosswordheaven.com/clues/corn-setting
Placekicker's pride	crosswordheaven.com/clues/placekickers-pride
Sock end	crosswordheaven.com/clues/sock-end
'Piggy'	crosswordheaven.com/clues/piggy
Water tester?	crosswordheaven.com/clues/water-tester
Place-kicker's pride	crosswordheaven.com/clues/place-kickers-pride
Foot  feature	crosswordheaven.com/clues/foot-feature
Corn holder	crosswordheaven.com/clues/corn-holder
Bodily digit	crosswordheaven.com/clues/bodily-digit
It has a nail	crosswordheaven.com/clues/it-has-a-nail
Stubbed part	crosswordheaven.com/clues/stubbed-part
Body part with a nail	crosswordheaven.com/clues/body-part-with-a-nail
Tot's 'piggy'	crosswordheaven.com/clues/tots-piggy
'Little piggy'	crosswordheaven.com/clues/little-piggy
Digit affected by gout	crosswordheaven.com/clues/digit-affected-by-gout
Tootsie	crosswordheaven.com/clues/tootsie
"Little piggy," in a children's rhyme	crosswordheaven.com/clues/little-piggy-in-a-childrens-rhyme
Crude pool thermometer?	crosswordheaven.com/clues/crude-pool-thermometer
With 49-Across, figure skating practice	crosswordheaven.com/clues/with-49-across-figure-skating-practice
Body part not covered by a thong	crosswordheaven.com/clues/body-part-not-covered-by-a-thong
Oft-stubbed extremity	crosswordheaven.com/clues/oft-stubbed-extremity
Turf ___ (gridder's malady)	crosswordheaven.com/clues/turf-___-gridders-malady
___ clip (bike part)	crosswordheaven.com/clues/___-clip-bike-part
Little digit	crosswordheaven.com/clues/little-digit
Turf ___: common football injury	crosswordheaven.com/clues/turf-___-common-football-injury
See 23-Across	crosswordheaven.com/clues/see-23-across
End of a game	crosswordheaven.com/clues/end-of-a-game
Slipper part	crosswordheaven.com/clues/slipper-part
Digit with a ring, maybe	crosswordheaven.com/clues/digit-with-a-ring-maybe
Third X or O	crosswordheaven.com/clues/third-x-or-o
Nursery "piggy"	crosswordheaven.com/clues/nursery-piggy
Tip trailer	crosswordheaven.com/clues/tip-trailer
Winning X or O	crosswordheaven.com/clues/winning-x-or-o
Pointe balancing point	crosswordheaven.com/clues/pointe-balancing-point
Tip-___	crosswordheaven.com/clues/tip-___
Sneaker part	crosswordheaven.com/clues/sneaker-part
End of a golf club	crosswordheaven.com/clues/end-of-a-golf-club
Word with tapper	crosswordheaven.com/clues/word-with-tapper
Digital print source?	crosswordheaven.com/clues/digital-print-source
Pirouette pivot	http://www.crosswordgiant.com/crossword-clue/217181/Pirouette-pivot
Foot part	http://www.crosswordgiant.com/crossword-clue/46918/Foot-part
Water tester	http://www.crosswordgiant.com/crossword-clue/1437/Water-tester
Sock part	http://www.crosswordgiant.com/crossword-clue/162622/Sock-part
Boot part	http://www.crosswordgiant.com/crossword-clue/6425/Boot-part
Low digit	http://www.crosswordgiant.com/crossword-clue/76718/Low-digit
Placekicker's pride	http://www.crosswordgiant.com/crossword-clue/286135/Placekickers-pride
Lower digit	http://www.crosswordgiant.com/crossword-clue/649559/Lower-digit
Foot digit	http://www.crosswordgiant.com/crossword-clue/480255/Foot-digit
Nail site	http://www.crosswordgiant.com/crossword-clue/362/Nail-site
Little piggy	http://www.crosswordgiant.com/crossword-clue/108522/Little-piggy
Shoe part	http://www.crosswordgiant.com/crossword-clue/42390/Shoe-part
Foot feature	http://www.crosswordgiant.com/crossword-clue/240908/Foot-feature
Corn site	http://www.crosswordgiant.com/crossword-clue/37029/Corn-site
Digit	http://www.crosswordgiant.com/crossword-clue/117844/Digit
Piggy	http://www.crosswordgiant.com/crossword-clue/154265/Piggy
Small digit	http://www.crosswordgiant.com/crossword-clue/210627/Small-digit
Bathwater tester	http://www.crosswordgiant.com/crossword-clue/73987/Bathwater-tester
Nail holder	http://www.crosswordgiant.com/crossword-clue/143099/Nail-holder
Tip of a sock	http://www.crosswordgiant.com/crossword-clue/637839/Tip-of-a-sock
Tip of a shoe	http://www.crosswordgiant.com/crossword-clue/748286/Tip-of-a-shoe
Stubbed digit	http://www.crosswordgiant.com/crossword-clue/877126/Stubbed-digit
Familiar tapper	http://www.crosswordgiant.com/crossword-clue/33736/Familiar-tapper
Unit smaller than a foot	http://www.crosswordgiant.com/crossword-clue/166952/Unit-smaller-than-a-foot
Place for a ring	http://www.crosswordgiant.com/crossword-clue/173318/Place-for-a-ring
Stocking stuffer?	http://www.crosswordgiant.com/crossword-clue/222758/Stocking-stuffer
Loafer part	http://www.crosswordgiant.com/crossword-clue/258687/Loafer-part
Big or little digit	http://www.crosswordgiant.com/crossword-clue/301813/Big-or-little-digit
Sandal sight	http://www.crosswordgiant.com/crossword-clue/447008/Sandal-sight
Tip of a boot	http://www.crosswordgiant.com/crossword-clue/869552/Tip-of-a-boot
Less than one foot in an easterly direction	http://www.crosswordgiant.com/crossword-clue/1057336/Less-than-one-foot-in-an-easterly-direction
Ring site	http://www.crosswordgiant.com/crossword-clue/3052/Ring-site
Pirouette point	http://www.crosswordgiant.com/crossword-clue/58019/Pirouette-point
Stocking part	http://www.crosswordgiant.com/crossword-clue/72339/Stocking-part
Low digit?	http://www.crosswordgiant.com/crossword-clue/81830/Low-digit
Ballerina's perch	http://www.crosswordgiant.com/crossword-clue/168578/Ballerinas-perch
Sock section	http://www.crosswordgiant.com/crossword-clue/180752/Sock-section
Place-kicker's pride	http://www.crosswordgiant.com/crossword-clue/228690/Place-kickers-pride
Kind of hold	http://www.crosswordgiant.com/crossword-clue/266929/Kind-of-hold
'Piggy'	http://www.crosswordgiant.com/crossword-clue/330648/Piggy
Nail setting	http://www.crosswordgiant.com/crossword-clue/357213/Nail-setting
Part of a sock	http://www.crosswordgiant.com/crossword-clue/414076/Part-of-a-sock
Tub temperature tester	http://www.crosswordgiant.com/crossword-clue/437059/Tub-temperature-tester
Stubbing victim	http://www.crosswordgiant.com/crossword-clue/441150/Stubbing-victim
Little dipper?	http://www.crosswordgiant.com/crossword-clue/479016/Little-dipper
Darn site	http://www.crosswordgiant.com/crossword-clue/56276/Darn-site
Stocking's end	http://www.crosswordgiant.com/crossword-clue/63522/Stockings-end
Corn holder	http://www.crosswordgiant.com/crossword-clue/81633/Corn-holder
Balance beam gripper	http://www.crosswordgiant.com/crossword-clue/84979/Balance-beam-gripper
Musician's tapper	http://www.crosswordgiant.com/crossword-clue/108754/Musicians-tapper
Water temperature tester	http://www.crosswordgiant.com/crossword-clue/121067/Water-temperature-tester
Wing-tip tip	http://www.crosswordgiant.com/crossword-clue/137766/Wing-tip-tip
Corn grower?	http://www.crosswordgiant.com/crossword-clue/138665/Corn-grower
Pedal digit	http://www.crosswordgiant.com/crossword-clue/187071/Pedal-digit
Ballerina's pivot	http://www.crosswordgiant.com/crossword-clue/194085/Ballerinas-pivot
Phalanx locale	http://www.crosswordgiant.com/crossword-clue/209375/Phalanx-locale
Type of hold	http://www.crosswordgiant.com/crossword-clue/216679/Type-of-hold
It can be big or little	http://www.crosswordgiant.com/crossword-clue/219113/It-can-be-big-or-little
Stubbed item	http://www.crosswordgiant.com/crossword-clue/225324/Stubbed-item
Corn setting	http://www.crosswordgiant.com/crossword-clue/263607/Corn-setting
Winning X or O	http://www.crosswordgiant.com/crossword-clue/271196/Winning-X-or-O
Kicker?	http://www.crosswordgiant.com/crossword-clue/310497/Kicker
Oft-stubbed digit	http://www.crosswordgiant.com/crossword-clue/348002/Oft-stubbed-digit
Digit that may be big	http://www.crosswordgiant.com/crossword-clue/387626/Digit-that-may-be-big
The third O of OOO	http://www.crosswordgiant.com/crossword-clue/406208/The-third-O-of-OOO
Stubbed thing	http://www.crosswordgiant.com/crossword-clue/429308/Stubbed-thing
Tot's 'piggy'	http://www.crosswordgiant.com/crossword-clue/450072/Tots-piggy
Golf-club part	http://www.crosswordgiant.com/crossword-clue/459755/Golf-club-part
Bunion spot	http://www.crosswordgiant.com/crossword-clue/466516/Bunion-spot
''Little piggie''	http://www.crosswordgiant.com/crossword-clue/480667/Little-piggie
Wingtip tip	http://www.crosswordgiant.com/crossword-clue/532026/Wingtip-tip
Stocking's tip	http://www.crosswordgiant.com/crossword-clue/555965/Stockings-tip
It may be pinched	http://www.crosswordgiant.com/crossword-clue/591576/It-may-be-pinched
Tip of a wingtip	http://www.crosswordgiant.com/crossword-clue/645564/Tip-of-a-wingtip
Place for a hole in a sock	http://www.crosswordgiant.com/crossword-clue/11353/Place-for-a-hole-in-a-sock
Part of the foot	http://www.crosswordgiant.com/crossword-clue/19817/Part-of-the-foot
Little piggy?	http://www.crosswordgiant.com/crossword-clue/43699/Little-piggy
Corn locale	http://www.crosswordgiant.com/crossword-clue/58649/Corn-locale
Nailed item	http://www.crosswordgiant.com/crossword-clue/107590/Nailed-item
Pool temperature tester	http://www.crosswordgiant.com/crossword-clue/129356/Pool-temperature-tester
Tip of a wing tip	http://www.crosswordgiant.com/crossword-clue/175024/Tip-of-a-wing-tip
Part of a foot	http://www.crosswordgiant.com/crossword-clue/220555/Part-of-a-foot
Foot  feature	http://www.crosswordgiant.com/crossword-clue/248153/Foot-feature
Darned spot?	http://www.crosswordgiant.com/crossword-clue/263837/Darned-spot
Darned spot	http://www.crosswordgiant.com/crossword-clue/281672/Darned-spot
Piggy who went to market	http://www.crosswordgiant.com/crossword-clue/317436/Piggy-who-went-to-market
Sneaker part	http://www.crosswordgiant.com/crossword-clue/322759/Sneaker-part
Pedicure target	http://www.crosswordgiant.com/crossword-clue/322886/Pedicure-target
Bunion's place	http://www.crosswordgiant.com/crossword-clue/325053/Bunions-place
__ the line (obey)	http://www.crosswordgiant.com/crossword-clue/363111/__-the-line-obey
Stocking stuffer?	http://www.crosswordgiant.com/crossword-clue/363148/Stocking-stuffer
Water tester?	http://www.crosswordgiant.com/crossword-clue/395899/Water-tester
Single digit	http://www.crosswordgiant.com/crossword-clue/399307/Single-digit
Tot's ''little piggie''	http://www.crosswordgiant.com/crossword-clue/490558/Tots-little-piggie
'Little piggy'	http://www.crosswordgiant.com/crossword-clue/505385/Little-piggy
Big __	http://www.crosswordgiant.com/crossword-clue/515280/Big-__
One of the little piggies	http://www.crosswordgiant.com/crossword-clue/519057/One-of-the-little-piggies
Bathwater tester?	http://www.crosswordgiant.com/crossword-clue/520001/Bathwater-tester
Sandal's lack	http://www.crosswordgiant.com/crossword-clue/532658/Sandals-lack
Boot tip	http://www.crosswordgiant.com/crossword-clue/536627/Boot-tip
One end of a sock	http://www.crosswordgiant.com/crossword-clue/641575/One-end-of-a-sock
Nail-polish target	http://www.crosswordgiant.com/crossword-clue/683517/Nail-polish-target
Tic-tac-__	http://www.crosswordgiant.com/crossword-clue/712827/Tic-tac-__
Last O of O-O-O	http://www.crosswordgiant.com/crossword-clue/725317/Last-O-of-O-O-O
Body part susceptible to frostbite	http://www.crosswordgiant.com/crossword-clue/787820/Body-part-susceptible-to-frostbite
Little piggy, so to speak	http://www.crosswordgiant.com/crossword-clue/814074/Little-piggy-so-to-speak
Stiff ballet shoe part	http://www.crosswordgiant.com/crossword-clue/829765/Stiff-ballet-shoe-part
Shoe tip	http://www.crosswordgiant.com/crossword-clue/892236/Shoe-tip
A foot division	http://www.crosswordgiant.com/crossword-clue/963424/A-foot-division
Conform - . . . the line	http://www.crosswordgiant.com/crossword-clue/1002843/Conform-.-.-.-the-line
One goes on foot in an easterly direction	http://www.crosswordgiant.com/crossword-clue/1053746/One-goes-on-foot-in-an-easterly-direction
Eastwards, perhaps, on foot	http://www.crosswordgiant.com/crossword-clue/1062077/Eastwards-perhaps-on-foot
On foot in an easterly direction	http://www.crosswordgiant.com/crossword-clue/1089304/On-foot-in-an-easterly-direction
In an easterly direction on foot	http://www.crosswordgiant.com/crossword-clue/1114257/In-an-easterly-direction-on-foot
Temperature tester	http://www.crosswordgiant.com/crossword-clue/1232740/Temperature-tester
Baby's "piggy"	http://www.crosswordgiant.com/crossword-clue/1410788/Babys-piggy
Part of Italy	http://www.crosswordgiant.com/crossword-clue/863/Part-of-Italy
Stocking stuffer	http://www.crosswordgiant.com/crossword-clue/20335/Stocking-stuffer
Turning point?	http://www.crosswordgiant.com/crossword-clue/22668/Turning-point
See 23-Across	http://www.crosswordgiant.com/crossword-clue/26122/See-23-Across
See 28-Across	http://www.crosswordgiant.com/crossword-clue/35052/See-28-Across
Golf club part	http://www.crosswordgiant.com/crossword-clue/43501/Golf-club-part
Gout spot	http://www.crosswordgiant.com/crossword-clue/45564/Gout-spot
Time keeper, at times	http://www.crosswordgiant.com/crossword-clue/48774/Time-keeper-at-times
Italy's bottom	http://www.crosswordgiant.com/crossword-clue/53546/Italys-bottom
Tootsie	http://www.crosswordgiant.com/crossword-clue/53854/Tootsie
Shoe part that may pinch	http://www.crosswordgiant.com/crossword-clue/55765/Shoe-part-that-may-pinch
It may test the waters	http://www.crosswordgiant.com/crossword-clue/59209/It-may-test-the-waters
Third X	http://www.crosswordgiant.com/crossword-clue/60654/Third-X
___ loop (skater's jump)	http://www.crosswordgiant.com/crossword-clue/63930/___-loop-skaters-jump
Water tester, maybe	http://www.crosswordgiant.com/crossword-clue/65712/Water-tester-maybe
Ballerina's asset	http://www.crosswordgiant.com/crossword-clue/81561/Ballerinas-asset
Slipper part	http://www.crosswordgiant.com/crossword-clue/112883/Slipper-part
Water tester, at times	http://www.crosswordgiant.com/crossword-clue/125151/Water-tester-at-times
Dactyl	http://www.crosswordgiant.com/crossword-clue/125415/Dactyl
Common darning spot	http://www.crosswordgiant.com/crossword-clue/130265/Common-darning-spot
It's tapped	http://www.crosswordgiant.com/crossword-clue/132939/Its-tapped
It's sometimes stubbed	http://www.crosswordgiant.com/crossword-clue/133552/Its-sometimes-stubbed
Turning point for Pavlova?	http://www.crosswordgiant.com/crossword-clue/137911/Turning-point-for-Pavlova
Bunions place	http://www.crosswordgiant.com/crossword-clue/144281/Bunions-place
Hose part	http://www.crosswordgiant.com/crossword-clue/149271/Hose-part
Pavlova's turning point?	http://www.crosswordgiant.com/crossword-clue/150240/Pavlovas-turning-point
Punt propeller?	http://www.crosswordgiant.com/crossword-clue/156680/Punt-propeller
End of a golf club	http://www.crosswordgiant.com/crossword-clue/157796/End-of-a-golf-club
Ballerina's support	http://www.crosswordgiant.com/crossword-clue/158974/Ballerinas-support
''--- the line!''	http://www.crosswordgiant.com/crossword-clue/163277/-the-line
Tap it	http://www.crosswordgiant.com/crossword-clue/168297/Tap-it
Place for a nail	http://www.crosswordgiant.com/crossword-clue/182406/Place-for-a-nail
It may be stubbed	http://www.crosswordgiant.com/crossword-clue/191278/It-may-be-stubbed
Hoof part	http://www.crosswordgiant.com/crossword-clue/200472/Hoof-part
Wing tip part	http://www.crosswordgiant.com/crossword-clue/208388/Wing-tip-part
Digital feature	http://www.crosswordgiant.com/crossword-clue/211334/Digital-feature
It may test the water	http://www.crosswordgiant.com/crossword-clue/213065/It-may-test-the-water
"___ the line!"	http://www.crosswordgiant.com/crossword-clue/237509/___-the-line
Bath-water tester	http://www.crosswordgiant.com/crossword-clue/241170/Bath-water-tester
Big digit	http://www.crosswordgiant.com/crossword-clue/244939/Big-digit
Big or little dipper	http://www.crosswordgiant.com/crossword-clue/249273/Big-or-little-dipper
Unit smaller than a foot?	http://www.crosswordgiant.com/crossword-clue/259447/Unit-smaller-than-a-foot
Hammer in obliquely	http://www.crosswordgiant.com/crossword-clue/262990/Hammer-in-obliquely
Bunion site	http://www.crosswordgiant.com/crossword-clue/264751/Bunion-site
Tip for a ballerina	http://www.crosswordgiant.com/crossword-clue/267598/Tip-for-a-ballerina
Bath water tester	http://www.crosswordgiant.com/crossword-clue/280672/Bath-water-tester
Body part	http://www.crosswordgiant.com/crossword-clue/281335/Body-part
Part of a shoe	http://www.crosswordgiant.com/crossword-clue/285961/Part-of-a-shoe
Little digit	http://www.crosswordgiant.com/crossword-clue/287439/Little-digit
Podiatrist's concern	http://www.crosswordgiant.com/crossword-clue/298983/Podiatrists-concern
XXX part	http://www.crosswordgiant.com/crossword-clue/303647/XXX-part
Golf club head part	http://www.crosswordgiant.com/crossword-clue/303950/Golf-club-head-part
It's nailed	http://www.crosswordgiant.com/crossword-clue/308492/Its-nailed
Corn location	http://www.crosswordgiant.com/crossword-clue/328790/Corn-location
Part of a pair of tights	http://www.crosswordgiant.com/crossword-clue/331396/Part-of-a-pair-of-tights
Third X, in a game	http://www.crosswordgiant.com/crossword-clue/333887/Third-X-in-a-game
Hammer on a slant	http://www.crosswordgiant.com/crossword-clue/351217/Hammer-on-a-slant
Limb's end	http://www.crosswordgiant.com/crossword-clue/354041/Limbs-end
Water temperature gauge	http://www.crosswordgiant.com/crossword-clue/356143/Water-temperature-gauge
Spot for a nail	http://www.crosswordgiant.com/crossword-clue/373231/Spot-for-a-nail
Head opposite	http://www.crosswordgiant.com/crossword-clue/382042/Head-opposite
Tapper, at times	http://www.crosswordgiant.com/crossword-clue/386552/Tapper-at-times
Water-temperature tester	http://www.crosswordgiant.com/crossword-clue/393138/Water-temperature-tester
Corn grower	http://www.crosswordgiant.com/crossword-clue/401535/Corn-grower
Foot's end	http://www.crosswordgiant.com/crossword-clue/402254/Foots-end
It's usually first into the tub	http://www.crosswordgiant.com/crossword-clue/403215/Its-usually-first-into-the-tub
Word with hold or nail	http://www.crosswordgiant.com/crossword-clue/406143/Word-with-hold-or-nail
Bathtime tester	http://www.crosswordgiant.com/crossword-clue/408307/Bathtime-tester
The third of three X's	http://www.crosswordgiant.com/crossword-clue/408983/The-third-of-three-Xs
Gout target, often	http://www.crosswordgiant.com/crossword-clue/411022/Gout-target-often
One of a rhino's 12	http://www.crosswordgiant.com/crossword-clue/413704/One-of-a-rhinos-12
Water temperature gauge, sometimes	http://www.crosswordgiant.com/crossword-clue/414507/Water-temperature-gauge-sometimes
AKA Hector (Blake)	http://www.crosswordgiant.com/crossword-clue/425359/AKA-Hector-Blake
Certain limb's end	http://www.crosswordgiant.com/crossword-clue/426201/Certain-limbs-end
Water-temperature gauge	http://www.crosswordgiant.com/crossword-clue/437963/Water-temperature-gauge
Kicker's digit?	http://www.crosswordgiant.com/crossword-clue/444466/Kickers-digit
Pedal part	http://www.crosswordgiant.com/crossword-clue/447331/Pedal-part
Head's opposite	http://www.crosswordgiant.com/crossword-clue/448188/Heads-opposite
Oft-tapped item	http://www.crosswordgiant.com/crossword-clue/452255/Oft-tapped-item
Shoe's end	http://www.crosswordgiant.com/crossword-clue/452573/Shoes-end
Polish target, perhaps	http://www.crosswordgiant.com/crossword-clue/452757/Polish-target-perhaps
One little piggy	http://www.crosswordgiant.com/crossword-clue/453880/One-little-piggy
Place for polish	http://www.crosswordgiant.com/crossword-clue/459682/Place-for-polish
Piggy who went to market, e.g.	http://www.crosswordgiant.com/crossword-clue/468106/Piggy-who-went-to-market-e.g
Foot end	http://www.crosswordgiant.com/crossword-clue/475915/Foot-end
Polish site	http://www.crosswordgiant.com/crossword-clue/485193/Polish-site
Terminal digit	http://www.crosswordgiant.com/crossword-clue/487603/Terminal-digit
Pirouetter's pivot	http://www.crosswordgiant.com/crossword-clue/491250/Pirouetters-pivot
One O of OOO	http://www.crosswordgiant.com/crossword-clue/494598/One-O-of-OOO
Shoe's tip	http://www.crosswordgiant.com/crossword-clue/495785/Shoes-tip
Word with tapper	http://www.crosswordgiant.com/crossword-clue/504701/Word-with-tapper
Baby's ''piggy''	http://www.crosswordgiant.com/crossword-clue/513923/Babys-piggy
Ballerina's digit	http://www.crosswordgiant.com/crossword-clue/521659/Ballerinas-digit
Sock end	http://www.crosswordgiant.com/crossword-clue/525309/Sock-end
Piggy, e.g.	http://www.crosswordgiant.com/crossword-clue/526612/Piggy-e.g
Foot ending	http://www.crosswordgiant.com/crossword-clue/531684/Foot-ending
Obey, with 'the line'	http://www.crosswordgiant.com/crossword-clue/560198/Obey-with-the-line
Beat tapper	http://www.crosswordgiant.com/crossword-clue/563435/Beat-tapper
The end of Italy, shapewise	http://www.crosswordgiant.com/crossword-clue/566579/The-end-of-Italy-shapewise
It can be painful when corny	http://www.crosswordgiant.com/crossword-clue/583682/It-can-be-painful-when-corny
Foot feature with phalanges	http://www.crosswordgiant.com/crossword-clue/587404/Foot-feature-with-phalanges
Word with ''hold'' or ''nail''	http://www.crosswordgiant.com/crossword-clue/589934/Word-with-hold-or-nail
Big ___ (body part)	http://www.crosswordgiant.com/crossword-clue/598441/Big-___-body-part
Word with ''tapper''	http://www.crosswordgiant.com/crossword-clue/601122/Word-with-tapper
__ the line: conform	http://www.crosswordgiant.com/crossword-clue/610238/__-the-line-conform
Place for a Dr. Scholl's pad	http://www.crosswordgiant.com/crossword-clue/616282/Place-for-a-Dr.-Scholls-pad
Occasional tapper	http://www.crosswordgiant.com/crossword-clue/619740/Occasional-tapper
Wingtip section	http://www.crosswordgiant.com/crossword-clue/624264/Wingtip-section
First thing in the water, usually	http://www.crosswordgiant.com/crossword-clue/625479/First-thing-in-the-water-usually
Stocking's end	http://www.crosswordgiant.com/crossword-clue/633758/Stockings-end
One may be stubbed	http://www.crosswordgiant.com/crossword-clue/652116/One-may-be-stubbed
Lou "The __" Groza, memorable NFL placekicker	http://www.crosswordgiant.com/crossword-clue/661109/Lou-The-__-Groza-memorable-NFL-placekicker
Last of three X's	http://www.crosswordgiant.com/crossword-clue/667177/Last-of-three-Xs
A minimus is the smallest one	http://www.crosswordgiant.com/crossword-clue/673505/A-minimus-is-the-smallest-one
Stocking's end	http://www.crosswordgiant.com/crossword-clue/678672/Stockings-end
It has a nail	http://www.crosswordgiant.com/crossword-clue/683487/It-has-a-nail
It may provide one's sole support	http://www.crosswordgiant.com/crossword-clue/686314/It-may-provide-ones-sole-support
Crude thermometer in the pool?	http://www.crosswordgiant.com/crossword-clue/686334/Crude-thermometer-in-the-pool
Minimus, e.g.	http://www.crosswordgiant.com/crossword-clue/693694/Minimus-e.g
Winning X	http://www.crosswordgiant.com/crossword-clue/707724/Winning-X
Stubbed part	http://www.crosswordgiant.com/crossword-clue/710664/Stubbed-part
Body part with a nail	http://www.crosswordgiant.com/crossword-clue/720584/Body-part-with-a-nail
Important part for a jig	http://www.crosswordgiant.com/crossword-clue/729663/Important-part-for-a-jig
Nether digit	http://www.crosswordgiant.com/crossword-clue/731694/Nether-digit
46-Across part	http://www.crosswordgiant.com/crossword-clue/731912/46-Across-part
Lower extremity	http://www.crosswordgiant.com/crossword-clue/731973/Lower-extremity
Bad dancer's target	http://www.crosswordgiant.com/crossword-clue/734214/Bad-dancers-target
Boot feature	http://www.crosswordgiant.com/crossword-clue/735182/Boot-feature
__ the line	http://www.crosswordgiant.com/crossword-clue/735540/__-the-line
Big and little digit	http://www.crosswordgiant.com/crossword-clue/741063/Big-and-little-digit
Tot's ''little piggie''	http://www.crosswordgiant.com/crossword-clue/746286/Tots-little-piggie
Chipped part of a statue, maybe	http://www.crosswordgiant.com/crossword-clue/746753/Chipped-part-of-a-statue-maybe
44-Down end	http://www.crosswordgiant.com/crossword-clue/747342/44-Down-end
___ loop (skating move)	http://www.crosswordgiant.com/crossword-clue/748039/___-loop-skating-move
Podiatrist's concern	http://www.crosswordgiant.com/crossword-clue/748506/Podiatrists-concern
Turf ___ (football player's malady)	http://www.crosswordgiant.com/crossword-clue/750956/Turf-___-football-players-malady
Turf ___ (football player's malady)	http://www.crosswordgiant.com/crossword-clue/752442/Turf-___-football-players-malady
Musician's tapper	http://www.crosswordgiant.com/crossword-clue/753815/Musicians-tapper
Something nailed	http://www.crosswordgiant.com/crossword-clue/755952/Something-nailed
Nail spot	http://www.crosswordgiant.com/crossword-clue/762145/Nail-spot
"Piggy"	http://www.crosswordgiant.com/crossword-clue/763696/Piggy
Tot's ''little piggie''	http://www.crosswordgiant.com/crossword-clue/771578/Tots-little-piggie
Third X in a game	http://www.crosswordgiant.com/crossword-clue/772022/Third-X-in-a-game
___ loop (skater's jump)	http://www.crosswordgiant.com/crossword-clue/777493/___-loop-skaters-jump
Sight in a sandal	http://www.crosswordgiant.com/crossword-clue/784248/Sight-in-a-sandal
Podiatrist's concern	http://www.crosswordgiant.com/crossword-clue/798631/Podiatrists-concern
Pavlova's pivot	http://www.crosswordgiant.com/crossword-clue/799606/Pavlovas-pivot
Pirouette pivot point	http://www.crosswordgiant.com/crossword-clue/801148/Pirouette-pivot-point
Place for polish, perhaps	http://www.crosswordgiant.com/crossword-clue/811652/Place-for-polish-perhaps
Ballerina's pivot	http://www.crosswordgiant.com/crossword-clue/815540/Ballerinas-pivot
It may have a painted nail	http://www.crosswordgiant.com/crossword-clue/815792/It-may-have-a-painted-nail
Ring site, perhaps	http://www.crosswordgiant.com/crossword-clue/820708/Ring-site-perhaps
Ballet pivot	http://www.crosswordgiant.com/crossword-clue/821372/Ballet-pivot
Water-testing digit	http://www.crosswordgiant.com/crossword-clue/823662/Water-testing-digit
___ the line (obey)	http://www.crosswordgiant.com/crossword-clue/830839/___-the-line-obey
Stocking's tip	http://www.crosswordgiant.com/crossword-clue/831246/Stockings-tip
Bodily digit	http://www.crosswordgiant.com/crossword-clue/835007/Bodily-digit
Bunion's place	http://www.crosswordgiant.com/crossword-clue/841287/Bunions-place
Nail or loop preceder	http://www.crosswordgiant.com/crossword-clue/844668/Nail-or-loop-preceder
Head's opposite	http://www.crosswordgiant.com/crossword-clue/845079/Heads-opposite
Sock tip	http://www.crosswordgiant.com/crossword-clue/848166/Sock-tip
It's often pointed in gymnastics	http://www.crosswordgiant.com/crossword-clue/848194/Its-often-pointed-in-gymnastics
Sock's end	http://www.crosswordgiant.com/crossword-clue/851556/Socks-end
"The __": placekicker Lou Groza's nickname	http://www.crosswordgiant.com/crossword-clue/852320/The-__-placekicker-Lou-Grozas-nickname
It's usually first into the tub	http://www.crosswordgiant.com/crossword-clue/863434/Its-usually-first-into-the-tub
One on the Statue of Liberty is almost three feet long	http://www.crosswordgiant.com/crossword-clue/863893/One-on-the-Statue-of-Liberty-is-almost-three-feet-long
Polish place, perhaps	http://www.crosswordgiant.com/crossword-clue/866489/Polish-place-perhaps
Word after big, middle, or little	http://www.crosswordgiant.com/crossword-clue/879530/Word-after-big-middle-or-little
Common gout site	http://www.crosswordgiant.com/crossword-clue/885325/Common-gout-site
Big or little follower	http://www.crosswordgiant.com/crossword-clue/886861/Big-or-little-follower
Oxford leader?	http://www.crosswordgiant.com/crossword-clue/888290/Oxford-leader
Part of Italy where Cape Spartivento is	http://www.crosswordgiant.com/crossword-clue/888518/Part-of-Italy-where-Cape-Spartivento-is
Water temperature gauge?	http://www.crosswordgiant.com/crossword-clue/898426/Water-temperature-gauge
Tip of a mule	http://www.crosswordgiant.com/crossword-clue/899124/Tip-of-a-mule
"Little piggie"	http://www.crosswordgiant.com/crossword-clue/901860/Little-piggie
Third X, in a simple game	http://www.crosswordgiant.com/crossword-clue/902300/Third-X-in-a-simple-game
Swimming pool tester	http://www.crosswordgiant.com/crossword-clue/907192/Swimming-pool-tester
Ballerina's pivot point	http://www.crosswordgiant.com/crossword-clue/913337/Ballerinas-pivot-point
Piggie	http://www.crosswordgiant.com/crossword-clue/913998/Piggie
Hammer obliquely	http://www.crosswordgiant.com/crossword-clue/917746/Hammer-obliquely
Little piggy, in a tot's rhyme	http://www.crosswordgiant.com/crossword-clue/917844/Little-piggy-in-a-tots-rhyme
Sock or foot part	http://www.crosswordgiant.com/crossword-clue/921840/Sock-or-foot-part
Bathwater temperature tester	http://www.crosswordgiant.com/crossword-clue/924628/Bathwater-temperature-tester
Body part that can be stubbed	http://www.crosswordgiant.com/crossword-clue/925048/Body-part-that-can-be-stubbed
One of the 10 lowest digits?	http://www.crosswordgiant.com/crossword-clue/925410/One-of-the-10-lowest-digits
Foot extremity.	http://www.crosswordgiant.com/crossword-clue/952223/Foot-extremity
Conform or obey; ... the line	http://www.crosswordgiant.com/crossword-clue/953954/Conform-or-obey-...-the-line
Conform - ... the line	http://www.crosswordgiant.com/crossword-clue/959912/Conform-...-the-line
Division of the foot	http://www.crosswordgiant.com/crossword-clue/969343/Division-of-the-foot
Conform-...the line	http://www.crosswordgiant.com/crossword-clue/992600/Conform-...the-line
Obey - . . . the line	http://www.crosswordgiant.com/crossword-clue/994281/Obey-.-.-.-the-line
One goes on foot 4 across	http://www.crosswordgiant.com/crossword-clue/1055370/One-goes-on-foot-4-across
Nothing from F to the final letter	http://www.crosswordgiant.com/crossword-clue/1071507/Nothing-from-F-to-the-final-letter
You'll have to be going with this on foot	http://www.crosswordgiant.com/crossword-clue/1079913/Youll-have-to-be-going-with-this-on-foot
One goes on foot in an easterly direction, it seems	http://www.crosswordgiant.com/crossword-clue/1080677/One-goes-on-foot-in-an-easterly-direction-it-seems
Sounds as if one might pull this less than one foot	http://www.crosswordgiant.com/crossword-clue/1098794/Sounds-as-if-one-might-pull-this-less-than-one-foot
On top of 19 across, might this bottom of you conform?	http://www.crosswordgiant.com/crossword-clue/1104719/On-top-of-19-across-might-this-bottom-of-you-conform
In an eastern direction on foot	http://www.crosswordgiant.com/crossword-clue/1121433/In-an-eastern-direction-on-foot
Less than a foot eastward	http://www.crosswordgiant.com/crossword-clue/1144033/Less-than-a-foot-eastward
Bit of a legend	http://www.crosswordgiant.com/crossword-clue/1157687/Bit-of-a-legend
Less than one foot in an eastern direction	http://www.crosswordgiant.com/crossword-clue/1160516/Less-than-one-foot-in-an-eastern-direction
The way to get to the East on foot	http://www.crosswordgiant.com/crossword-clue/1164336/The-way-to-get-to-the-East-on-foot
Not so far as F, perhaps, on foot	http://www.crosswordgiant.com/crossword-clue/1167157/Not-so-far-as-F-perhaps-on-foot
'On foot in an easterly direction, perhaps (3)'	http://www.crosswordgiant.com/crossword-clue/1170082/On-foot-in-an-easterly-direction-perhaps-3
Would this one get one to the Orient on foot?	http://www.crosswordgiant.com/crossword-clue/1170777/Would-this-one-get-one-to-the-Orient-on-foot
It may be painted	http://www.crosswordgiant.com/crossword-clue/1191978/It-may-be-painted
Stubbed extremity	http://www.crosswordgiant.com/crossword-clue/1201524/Stubbed-extremity
It may be tapped at a concert	http://www.crosswordgiant.com/crossword-clue/1202009/It-may-be-tapped-at-a-concert
Pivot point when en pointe	http://www.crosswordgiant.com/crossword-clue/1206031/Pivot-point-when-en-pointe
Sub-unit of a foot	http://www.crosswordgiant.com/crossword-clue/1206600/Sub-unit-of-a-foot
Ballerina's balancing point	http://www.crosswordgiant.com/crossword-clue/1215269/Ballerinas-balancing-point
Little wiggler	http://www.crosswordgiant.com/crossword-clue/1228281/Little-wiggler
Follower of tic-tac	http://www.crosswordgiant.com/crossword-clue/1232147/Follower-of-tic-tac
'Little piggy,' in a children's rhyme	http://www.crosswordgiant.com/crossword-clue/1238559/Little-piggy-in-a-childrens-rhyme
Crude pool thermometer?	http://www.crosswordgiant.com/crossword-clue/1243623/Crude-pool-thermometer
With 49-Across, figure skating practice	http://www.crosswordgiant.com/crossword-clue/1246151/With-49-Across-figure-skating-practice
Strove every second for low digit	http://www.crosswordgiant.com/crossword-clue/1248260/Strove-every-second-for-low-digit
Body part not covered by a thong	http://www.crosswordgiant.com/crossword-clue/1254399/Body-part-not-covered-by-a-thong
Oft-stubbed extremity	http://www.crosswordgiant.com/crossword-clue/1255457/Oft-stubbed-extremity
... or at its end	http://www.crosswordgiant.com/crossword-clue/1383599/...-or-at-its-end
Digit on foot	http://www.crosswordgiant.com/crossword-clue/1386196/Digit-on-foot
Corn's locale, often	http://www.crosswordgiant.com/crossword-clue/1406183/Corns-locale-often
__ clip (bike part)	http://www.crosswordgiant.com/crossword-clue/1414125/__-clip-bike-part
Turf __: common football injury	http://www.crosswordgiant.com/crossword-clue/1422027/Turf-__-common-football-injury
Digit with a ring, maybe	http://www.crosswordgiant.com/crossword-clue/1439138/Digit-with-a-ring-maybe
Piggy who went to market on foot	http://www.crosswordgiant.com/crossword-clue/1440094/Piggy-who-went-to-market-on-foot
Third X or O	http://www.crosswordgiant.com/crossword-clue/1444767/Third-X-or-O
Nursery "piggy"	http://www.crosswordgiant.com/crossword-clue/1449700/Nursery-piggy
Tip trailer	http://www.crosswordgiant.com/crossword-clue/1450071/Tip-trailer
Pointe balancing point	http://www.crosswordgiant.com/crossword-clue/1465829/Pointe-balancing-point
Tip-___	http://www.crosswordgiant.com/crossword-clue/1472971/Tip-___
Toddler's piggy	http://www.crosswordgiant.com/crossword-clue/1496231/Toddlers-piggy
Digital print source?	http://www.crosswordgiant.com/crossword-clue/1500196/Digital-print-source
