Attempt	crosswordtracker.com/clue/attempt/
Try	crosswordtracker.com/clue/try/
Composition	crosswordtracker.com/clue/composition-16/
Try out	crosswordtracker.com/clue/try-out/
Theme	crosswordtracker.com/clue/theme/
Time piece?	crosswordtracker.com/clue/time-piece/
Trial	crosswordtracker.com/clue/trial/
Put to the test	crosswordtracker.com/clue/put-to-the-test/
Op-ed piece	crosswordtracker.com/clue/op-ed-piece/
Opinion piece	crosswordtracker.com/clue/opinion-piece/
Test type	crosswordtracker.com/clue/test-type/
Endeavor	crosswordtracker.com/clue/endeavor/
Strive	crosswordtracker.com/clue/strive/
School assignment	crosswordtracker.com/clue/school-assignment/
Type of test	crosswordtracker.com/clue/type-of-test/
English homework, perhaps	crosswordtracker.com/clue/english-homework-perhaps/
Piece of bacon	crosswordtracker.com/clue/piece-of-bacon/
Blue book filler	crosswordtracker.com/clue/blue-book-filler/
English assignment	crosswordtracker.com/clue/english-assignment/
Lamb serving	crosswordtracker.com/clue/lamb-serving/
Exam type	crosswordtracker.com/clue/exam-type/
Take a crack at	crosswordtracker.com/clue/take-a-crack-at/
English class assignment	crosswordtracker.com/clue/english-class-assignment-1/
Lamb specialty	crosswordtracker.com/clue/lamb-specialty/
English-class assignment	crosswordtracker.com/clue/english-class-assignment/
Homework assignment	crosswordtracker.com/clue/homework-assignment/
It has a point	crosswordtracker.com/clue/it-has-a-point/
Think piece	crosswordtracker.com/clue/think-piece/
Lamb piece	crosswordtracker.com/clue/lamb-piece/
Lamb product	crosswordtracker.com/clue/lamb-product/
Bacon piece	crosswordtracker.com/clue/bacon-piece/
Writing class assignment	crosswordtracker.com/clue/writing-class-assignment/
Pope piece	crosswordtracker.com/clue/pope-piece/
Prose piece	crosswordtracker.com/clue/prose-piece/
Pundit's piece	crosswordtracker.com/clue/pundits-piece/
SAT section	crosswordtracker.com/clue/sat-section/
Literary composition	crosswordtracker.com/clue/literary-composition/
"How I Spent My Summer Vacation," maybe	crosswordtracker.com/clue/how-i-spent-my-summer-vacation-maybe/
Swift work	crosswordtracker.com/clue/swift-work/
College application part	crosswordtracker.com/clue/college-application-part/
Swift's "A Modest Proposal," e.g.	crosswordtracker.com/clue/swifts-a-modest-proposal-eg/
Op-Ed piece, e.g.	crosswordtracker.com/clue/op-ed-piece-eg/
Written composition	crosswordtracker.com/clue/written-composition/
Piece of Bacon?	crosswordtracker.com/clue/piece-of-bacon-1/
English exam finale, often	crosswordtracker.com/clue/english-exam-finale-often/
Blue-book filler	crosswordtracker.com/clue/blue-book-filler-1/
Writing assignment	crosswordtracker.com/clue/writing-assignment/
Test format	crosswordtracker.com/clue/test-format-1/
Lengthy test answer	crosswordtracker.com/clue/lengthy-test-answer/
Bacon bit	crosswordtracker.com/clue/bacon-bit-1/
Blue-book composition	crosswordtracker.com/clue/blue-book-composition/
"Civil Disobedience," e.g.	crosswordtracker.com/clue/civil-disobedience-eg-1/
School composition	crosswordtracker.com/clue/school-composition/
English paper	crosswordtracker.com/clue/english-paper/
Bacon bit?	crosswordtracker.com/clue/bacon-bit/
Bacon product	crosswordtracker.com/clue/bacon-product/
Blue book entry	crosswordtracker.com/clue/blue-book-entry/
Emerson work	crosswordtracker.com/clue/emerson-work/
Social Studies assignment	crosswordtracker.com/clue/social-studies-assignment/
Virginia Woolf piece	crosswordtracker.com/clue/virginia-woolf-piece/
Class paper	crosswordtracker.com/clue/class-paper/
Test format, sometimes	crosswordtracker.com/clue/test-format-sometimes/
Question type	crosswordtracker.com/clue/question-type-1/
Calvin Trillin piece	crosswordtracker.com/clue/calvin-trillin-piece-1/
George Will piece	crosswordtracker.com/clue/george-will-piece/
Piece in Harper's	crosswordtracker.com/clue/piece-in-harpers/
English test, perhaps	crosswordtracker.com/clue/english-test-perhaps/
Emerson product	crosswordtracker.com/clue/emerson-product/
SAT component	crosswordtracker.com/clue/sat-component/
Alexander Pope piece	crosswordtracker.com/clue/alexander-pope-piece/
Feature in Harper's or The Atlantic	crosswordtracker.com/clue/feature-in-harpers-or-the-atlantic/
Thoreau's "Civil Disobedience," for one	crosswordtracker.com/clue/thoreaus-civil-disobedience-for-one/
English test requirement, often	crosswordtracker.com/clue/english-test-requirement-often/
Expository writing class assignment	crosswordtracker.com/clue/expository-writing-class-assignment/
Common college admission requirement	crosswordtracker.com/clue/common-college-admission-requirement/
Certain English assignment	crosswordtracker.com/clue/certain-english-assignment/
High-school composition	crosswordtracker.com/clue/high-school-composition/
''Civil Disobedience,'' e.g.	crosswordtracker.com/clue/civil-disobedience-eg/
The New Yorker piece	crosswordtracker.com/clue/the-new-yorker-piece/
Emerson effort	crosswordtracker.com/clue/emerson-effort/
"The New Yorker" piece	crosswordtracker.com/clue/the-new-yorker-piece-1/
Montaigne's writing form	crosswordtracker.com/clue/montaignes-writing-form/
Long test answer	crosswordtracker.com/clue/long-test-answer/
Long answer on a test	crosswordtracker.com/clue/long-answer-on-a-test/
Blue book test answer	crosswordtracker.com/clue/blue-book-test-answer/
Part of a Social Studies test	crosswordtracker.com/clue/part-of-a-social-studies-test/
Gore Vidal piece	crosswordtracker.com/clue/gore-vidal-piece/
Part of many a history test	crosswordtracker.com/clue/part-of-many-a-history-test/
Student's composition	crosswordtracker.com/clue/students-composition/
Samuel Johnson work	crosswordtracker.com/clue/samuel-johnson-work/
Opinionated work	crosswordtracker.com/clue/opinionated-work/
College application piece, perhaps	crosswordtracker.com/clue/college-application-piece-perhaps/
Montaigne piece	crosswordtracker.com/clue/montaigne-piece/
Paper piece	crosswordtracker.com/clue/paper-piece/
Composition with a viewpoint	crosswordtracker.com/clue/composition-with-a-viewpoint/
Part of a college application	crosswordtracker.com/clue/part-of-a-college-application/
Lamb or Bacon piece	crosswordtracker.com/clue/lamb-or-bacon-piece/
Part of the SAT	crosswordtracker.com/clue/part-of-the-sat/
"How I Spent My Summer," often	crosswordtracker.com/clue/how-i-spent-my-summer-often/
"A Modest Proposal," e.g.	crosswordtracker.com/clue/a-modest-proposal-eg/
Paper	crosswordtracker.com/clue/paper-217/
Emerson piece	crosswordtracker.com/clue/emerson-piece/
English test segment, perhaps	crosswordtracker.com/clue/english-test-segment-perhaps/
Maureen Dowd piece	crosswordtracker.com/clue/maureen-dowd-piece/
Pope's "An _____ on Man"	crosswordtracker.com/clue/popes-an-_____-on-man/
E. B. White piece	crosswordtracker.com/clue/e-b-white-piece/
Piece of Lamb or Bacon	crosswordtracker.com/clue/piece-of-lamb-or-bacon/
Blog entry, maybe	crosswordtracker.com/clue/blog-entry-maybe/
Persuasive piece	crosswordtracker.com/clue/persuasive-piece/
Bit of literature	crosswordtracker.com/clue/bit-of-literature/
Treatise	crosswordtracker.com/clue/treatise-4/
W.E.B. Du Bois work	crosswordtracker.com/clue/web-du-bois-work/
English test requirement	crosswordtracker.com/clue/english-test-requirement-1/
Five-paragraph response, perhaps	crosswordtracker.com/clue/five-paragraph-response-perhaps/
Five-paragraph assignment, perhaps	crosswordtracker.com/clue/five-paragraph-assignment-perhaps/
Five-paragraph piece, perhaps	crosswordtracker.com/clue/five-paragraph-piece-perhaps/
Alternative to multiple choice	crosswordtracker.com/clue/alternative-to-multiple-choice/
High-school exam part	crosswordtracker.com/clue/high-school-exam-part/
Susan Sontag piece	crosswordtracker.com/clue/susan-sontag-piece/
English exam, often	crosswordtracker.com/clue/english-exam-often/
Test question, maybe	crosswordtracker.com/clue/test-question-maybe/
"A literary device for saying almost everything about almost anything": Huxley	crosswordtracker.com/clue/a-literary-device-for-saying-almost-everything-about-almost-anything-huxley/
Op-ed column, e.g.	crosswordtracker.com/clue/op-ed-column-eg/
Addison and Steele piece	crosswordtracker.com/clue/addison-and-steele-piece/
Samuel Johnson's "The False Alarm," e.g.	crosswordtracker.com/clue/samuel-johnsons-the-false-alarm-eg/
SAT part	crosswordtracker.com/clue/sat-part/
Editorial piece	crosswordtracker.com/clue/editorial-piece/
Personal prose unit	crosswordtracker.com/clue/personal-prose-unit/
English test component	crosswordtracker.com/clue/english-test-component/
Test you can't really guess on	crosswordtracker.com/clue/test-you-cant-really-guess-on/
"The Federalist" component	crosswordtracker.com/clue/the-federalist-component/
Piece of prose	crosswordtracker.com/clue/piece-of-prose/
Exam type you can't guess on	crosswordtracker.com/clue/exam-type-you-cant-guess-on/
Part of some exams	crosswordtracker.com/clue/part-of-some-exams/
Op-ed offering	crosswordtracker.com/clue/op-ed-offering/
English homework	crosswordtracker.com/clue/english-homework/
History class homework, perhaps	crosswordtracker.com/clue/history-class-homework-perhaps/
Part of many an English exam	crosswordtracker.com/clue/part-of-many-an-english-exam/
Writing contest entry, often	crosswordtracker.com/clue/writing-contest-entry-often/
Gore Vidal composition	crosswordtracker.com/clue/gore-vidal-composition/
Kind of test answer	crosswordtracker.com/clue/kind-of-test-answer/
National Review piece	crosswordtracker.com/clue/national-review-piece/
School assignment, perhaps	crosswordtracker.com/clue/school-assignment-perhaps/
History homework, sometimes	crosswordtracker.com/clue/history-homework-sometimes/
Calvin Trillin piece, perhaps	crosswordtracker.com/clue/calvin-trillin-piece-perhaps/
Exam part, sometimes	crosswordtracker.com/clue/exam-part-sometimes/
''How I Spent My Summer Vacation,'' maybe	crosswordtracker.com/clue/how-i-spent-my-summer-vacation-maybe-1/
Op-Ed article	crosswordtracker.com/clue/op-ed-article/
Written test type	crosswordtracker.com/clue/written-test-type/
Magazine piece, sometimes	crosswordtracker.com/clue/magazine-piece-sometimes/
Position paper	crosswordtracker.com/clue/position-paper/
Emerson opus	crosswordtracker.com/clue/emerson-opus/
English final exam, perhaps	crosswordtracker.com/clue/english-final-exam-perhaps/
Contest entry	crosswordtracker.com/clue/contest-entry-1/
Long-form writing assignment	crosswordtracker.com/clue/long-form-writing-assignment/
SAT segment	crosswordtracker.com/clue/sat-segment/
Article in Harper's	crosswordtracker.com/clue/article-in-harpers/
Test composition	crosswordtracker.com/clue/test-composition/
Op-ed, typically	crosswordtracker.com/clue/op-ed-typically/
Journal submission	crosswordtracker.com/clue/journal-submission/
Piece in The New Republic	crosswordtracker.com/clue/piece-in-the-new-republic/
Â  Â  Bacon piece	crosswordtracker.com/clue/bacon-piece-1/
Charles Lamb piece	crosswordtracker.com/clue/charles-lamb-piece/
Piece of schoolwork	crosswordtracker.com/clue/piece-of-schoolwork/
Op-ed piece, usually	crosswordtracker.com/clue/op-ed-piece-usually/
History class assignment	crosswordtracker.com/clue/history-class-assignment/
Common college admissions requirement	crosswordtracker.com/clue/common-college-admissions-requirement/
Long English assignment	crosswordtracker.com/clue/long-english-assignment/
Exam portion, perhaps	crosswordtracker.com/clue/exam-portion-perhaps/
English composition	crosswordtracker.com/clue/english-composition/
"Civil Disobedience" is one	crosswordtracker.com/clue/civil-disobedience-is-one/
Steele work	crosswordtracker.com/clue/steele-work/
History test section, often	crosswordtracker.com/clue/history-test-section-often/
Longish blog post	crosswordtracker.com/clue/longish-blog-post/
History test component	crosswordtracker.com/clue/history-test-component/
Frank Rich piece	crosswordtracker.com/clue/frank-rich-piece/
Pope production	crosswordtracker.com/clue/pope-production/
Nora Ephron work	crosswordtracker.com/clue/nora-ephron-work/
Very long-winded answer	crosswordtracker.com/clue/very-long-winded-answer/
Bacon or Lamb product	crosswordtracker.com/clue/bacon-or-lamb-product/
College application need	crosswordtracker.com/clue/college-application-need/
Russell Baker specialty	crosswordtracker.com/clue/russell-baker-specialty/
Written test answer	crosswordtracker.com/clue/written-test-answer/
Article in Harper's or The Atlantic	crosswordtracker.com/clue/article-in-harpers-or-the-atlantic/
Final exam, maybe	crosswordtracker.com/clue/final-exam-maybe/
Locke work	crosswordtracker.com/clue/locke-work/
Part of many a college application	crosswordtracker.com/clue/part-of-many-a-college-application/
Lamb creation	crosswordtracker.com/clue/lamb-creation-1/
Elia's specialty	crosswordtracker.com/clue/elias-specialty/
Montaigne's specialty	crosswordtracker.com/clue/montaignes-specialty/
Macaulay product	crosswordtracker.com/clue/macaulay-product/
Joseph Addison product	crosswordtracker.com/clue/joseph-addison-product/
Dryden work	crosswordtracker.com/clue/dryden-work/
New Republic piece	crosswordtracker.com/clue/new-republic-piece/
Test format, often	crosswordtracker.com/clue/test-format-often/
Federalist paper	crosswordtracker.com/clue/federalist-paper/
Bacon work	crosswordtracker.com/clue/bacon-work/
Locke opus	crosswordtracker.com/clue/locke-opus/
Elia product	crosswordtracker.com/clue/elia-product/
Repplier work	crosswordtracker.com/clue/repplier-work/
School project	crosswordtracker.com/clue/school-project-1/
Poetic Pope product	crosswordtracker.com/clue/poetic-pope-product/
Â“The Federalist PapersÂ” piece	crosswordtracker.com/clue/the-federalist-papers-piece/
Thoreau tract	crosswordtracker.com/clue/thoreau-tract/
Magazine piece, often	crosswordtracker.com/clue/magazine-piece-often/
Type of test you can't guess on	crosswordtracker.com/clue/type-of-test-you-cant-guess-on/
Test that's tough to cheat on	crosswordtracker.com/clue/test-thats-tough-to-cheat-on/
Test section, often	crosswordtracker.com/clue/test-section-often/
New SAT component	crosswordtracker.com/clue/new-sat-component/
"How I Spent My Summer Vacation" e.g.	crosswordtracker.com/clue/how-i-spent-my-summer-vacation-eg/
"How I Spent My Summer Vacation," e.g.	crosswordtracker.com/clue/how-i-spent-my-summer-vacation-eg-1/
Test segment, perhaps	crosswordtracker.com/clue/test-segment-perhaps/
English test, sometimes	crosswordtracker.com/clue/english-test-sometimes/
English 101 assignment	crosswordtracker.com/clue/english-101-assignment/
The Atlantic piece	crosswordtracker.com/clue/the-atlantic-piece/
E.B. White work	crosswordtracker.com/clue/eb-white-work/
Homework assignment, sometimes	crosswordtracker.com/clue/homework-assignment-sometimes/
Schoolboy's grammatical exercise	crosswordtracker.com/clue/schoolboys-grammatical-exercise/
Emerson's "Self-Reliance," for one	crosswordtracker.com/clue/emersons-self-reliance-for-one/
Homework assignment in English, often	crosswordtracker.com/clue/homework-assignment-in-english-often/
"A Modest Proposal" e.g.	crosswordtracker.com/clue/a-modest-proposal-eg-1/
Bacon product?	crosswordtracker.com/clue/bacon-product-2/
College applicant's creation	crosswordtracker.com/clue/college-applicants-creation/
Blue-book filler, perhaps	crosswordtracker.com/clue/blue-book-filler-perhaps/
Test format, perhaps	crosswordtracker.com/clue/test-format-perhaps/
Thoreau composition	crosswordtracker.com/clue/thoreau-composition/
Foucault product	crosswordtracker.com/clue/foucault-product/
Lamb 's tale	crosswordtracker.com/clue/lamb-s-tale/
College application component	crosswordtracker.com/clue/college-application-component/
Piece with a point (5)	crosswordtracker.com/clue/piece-with-a-point-5/
Test answer, maybe	crosswordtracker.com/clue/test-answer-maybe/
Bacon piece?	crosswordtracker.com/clue/bacon-piece-3/
Attempt	crosswordheaven.com/clues/attempt
Russell Baker specialty	crosswordheaven.com/clues/russell-baker-specialty
Lamb product	crosswordheaven.com/clues/lamb-product
School assignment	crosswordheaven.com/clues/school-assignment
Opinionated work	crosswordheaven.com/clues/opinionated-work
16-Across work	crosswordheaven.com/clues/16-across-work
Bacon product	crosswordheaven.com/clues/bacon-product
Calvin Trillin piece	crosswordheaven.com/clues/calvin-trillin-piece
"Civil Disobedience," e.g.	crosswordheaven.com/clues/civil-disobedience-eg
Swift work	crosswordheaven.com/clues/swift-work
English exam finale, often	crosswordheaven.com/clues/english-exam-finale-often
Bacon piece	crosswordheaven.com/clues/bacon-piece
Emerson work	crosswordheaven.com/clues/emerson-work
Article in Harper's or The Atlantic	crosswordheaven.com/clues/article-in-harpers-or-the-atlantic
Blue-book filler	crosswordheaven.com/clues/blue-book-filler
Piece in Harper's	crosswordheaven.com/clues/piece-in-harpers
English paper	crosswordheaven.com/clues/english-paper
Think piece	crosswordheaven.com/clues/think-piece
With 64-Across, a student's challenge	crosswordheaven.com/clues/with-64-across-a-students-challenge
Pope production	crosswordheaven.com/clues/pope-production
Test format	crosswordheaven.com/clues/test-format
Bacon bit	crosswordheaven.com/clues/bacon-bit
College application part	crosswordheaven.com/clues/college-application-part
"How I Spent My Summer Vacation," maybe	crosswordheaven.com/clues/how-i-spent-my-summer-vacation-maybe
Paper	crosswordheaven.com/clues/paper
Op-ed piece	crosswordheaven.com/clues/op-ed-piece
Emerson piece	crosswordheaven.com/clues/emerson-piece
Very long-winded answer	crosswordheaven.com/clues/very-long-winded-answer
"A Modest Proposal," e.g.	crosswordheaven.com/clues/a-modest-proposal-eg
Lamb specialty	crosswordheaven.com/clues/lamb-specialty
English assignment	crosswordheaven.com/clues/english-assignment
Time piece?	crosswordheaven.com/clues/time-piece
Composition with a viewpoint	crosswordheaven.com/clues/composition-with-a-viewpoint
Bacon or Lamb product	crosswordheaven.com/clues/bacon-or-lamb-product
Opinion piece	crosswordheaven.com/clues/opinion-piece
Op-ed piece, e.g.	crosswordheaven.com/clues/op-ed-piece-eg
Journal submission	crosswordheaven.com/clues/journal-submission
Blue book filler	crosswordheaven.com/clues/blue-book-filler
Prose piece	crosswordheaven.com/clues/prose-piece
Â  Â  Bacon piece	crosswordheaven.com/clues/bacon-piece
Piece in The New Republic	crosswordheaven.com/clues/piece-in-the-new-republic
Analytic work	crosswordheaven.com/clues/analytic-work
Op-ed, typically	crosswordheaven.com/clues/op-ed-typically
Writing contest entry	crosswordheaven.com/clues/writing-contest-entry
Theme	crosswordheaven.com/clues/theme
Swift's "A Modest Proposal," e.g.	crosswordheaven.com/clues/swifts-a-modest-proposal-eg
Lamb or Bacon piece	crosswordheaven.com/clues/lamb-or-bacon-piece
Pundit's piece	crosswordheaven.com/clues/pundits-piece
Part of a college application	crosswordheaven.com/clues/part-of-a-college-application
Lamb piece	crosswordheaven.com/clues/lamb-piece
Test type	crosswordheaven.com/clues/test-type
Piece of Lamb?	crosswordheaven.com/clues/piece-of-lamb
Alexander Pope work	crosswordheaven.com/clues/alexander-pope-work
Kind of test question	crosswordheaven.com/clues/kind-of-test-question
High school composition	crosswordheaven.com/clues/high-school-composition
Blue-book filler, maybe	crosswordheaven.com/clues/blue-book-filler-maybe
English paper, often	crosswordheaven.com/clues/english-paper-often
Scholarship entry, sometimes	crosswordheaven.com/clues/scholarship-entry-sometimes
Gore Vidal piece, perhaps	crosswordheaven.com/clues/gore-vidal-piece-perhaps
Part of a history test, sometimes	crosswordheaven.com/clues/part-of-a-history-test-sometimes
Part of many a history test	crosswordheaven.com/clues/part-of-many-a-history-test
Written composition	crosswordheaven.com/clues/written-composition
Piece with a purpose	crosswordheaven.com/clues/piece-with-a-purpose
Position paper	crosswordheaven.com/clues/position-paper
Piece of Bacon?	crosswordheaven.com/clues/piece-of-bacon
Blue book test answer	crosswordheaven.com/clues/blue-book-test-answer
Writing contest entry, often	crosswordheaven.com/clues/writing-contest-entry-often
Gore Vidal composition	crosswordheaven.com/clues/gore-vidal-composition
Kind of test answer	crosswordheaven.com/clues/kind-of-test-answer
Long test answer	crosswordheaven.com/clues/long-test-answer
National Review piece	crosswordheaven.com/clues/national-review-piece
Long answer on a test	crosswordheaven.com/clues/long-answer-on-a-test
Part of a Social Studies test	crosswordheaven.com/clues/part-of-a-social-studies-test
Lamb serving	crosswordheaven.com/clues/lamb-serving
Part of many an English exam	crosswordheaven.com/clues/part-of-many-an-english-exam
Social Studies assignment	crosswordheaven.com/clues/social-studies-assignment
Op-ed offering	crosswordheaven.com/clues/op-ed-offering
Writing class assignment	crosswordheaven.com/clues/writing-class-assignment
Montaigne's writing form	crosswordheaven.com/clues/montaignes-writing-form
Emerson effort	crosswordheaven.com/clues/emerson-effort
English homework	crosswordheaven.com/clues/english-homework
English class assignment	crosswordheaven.com/clues/english-class-assignment
"The New Yorker" piece	crosswordheaven.com/clues/the-new-yorker-piece
Class paper	crosswordheaven.com/clues/class-paper
History class homework, perhaps	crosswordheaven.com/clues/history-class-homework-perhaps
Put to the test	crosswordheaven.com/clues/put-to-the-test
"The Federalist" component	crosswordheaven.com/clues/the-federalist-component
Blue book entry	crosswordheaven.com/clues/blue-book-entry
Exam type you can't guess on	crosswordheaven.com/clues/exam-type-you-cant-guess-on
Expository writing class assignment	crosswordheaven.com/clues/expository-writing-class-assignment
Part of the SAT	crosswordheaven.com/clues/part-of-the-sat
Pope piece	crosswordheaven.com/clues/pope-piece
Thoreau tract	crosswordheaven.com/clues/thoreau-tract
Question type	crosswordheaven.com/clues/question-type
Magazine piece, often	crosswordheaven.com/clues/magazine-piece-often
Piece of Bacon	crosswordheaven.com/clues/piece-of-bacon
School composition	crosswordheaven.com/clues/school-composition
Piece of Lamb or Bacon	crosswordheaven.com/clues/piece-of-lamb-or-bacon
"A literary device for saying almost everything about almost anything": Huxley	crosswordheaven.com/clues/a-literary-device-for-saying-almost-everything-about-almost-anything-huxley
Bacon bit?	crosswordheaven.com/clues/bacon-bit
Op-ed column, e.g.	crosswordheaven.com/clues/op-ed-column-eg
Samuel Johnson's "The False Alarm," e.g.	crosswordheaven.com/clues/samuel-johnsons-the-false-alarm-eg
SAT part	crosswordheaven.com/clues/sat-part
Try	crosswordheaven.com/clues/try
English test component	crosswordheaven.com/clues/english-test-component
Common college admission requirement	crosswordheaven.com/clues/common-college-admission-requirement
The New Yorker piece	crosswordheaven.com/clues/the-new-yorker-piece
Test you can't really guess on	crosswordheaven.com/clues/test-you-cant-really-guess-on
New SAT component	crosswordheaven.com/clues/new-sat-component
Samuel Johnson work	crosswordheaven.com/clues/samuel-johnson-work
Homework assignment	crosswordheaven.com/clues/homework-assignment
High-school composition	crosswordheaven.com/clues/high-school-composition
English-class assignment	crosswordheaven.com/clues/english-class-assignment
Addison and Steele piece	crosswordheaven.com/clues/addison-and-steele-piece
Editorial piece	crosswordheaven.com/clues/editorial-piece
High-school exam part	crosswordheaven.com/clues/high-school-exam-part
Endeavor	crosswordheaven.com/clues/endeavor
Test question, maybe	crosswordheaven.com/clues/test-question-maybe
Take a crack at	crosswordheaven.com/clues/take-a-crack-at
Thoreau composition	crosswordheaven.com/clues/thoreau-composition
Foucault product	crosswordheaven.com/clues/foucault-product
Student's composition	crosswordheaven.com/clues/students-composition
Feature in Harper's or The Atlantic	crosswordheaven.com/clues/feature-in-harpers-or-the-atlantic
Written test type	crosswordheaven.com/clues/written-test-type
Calvin Trillin piece, perhaps	crosswordheaven.com/clues/calvin-trillin-piece-perhaps
Exam part, sometimes	crosswordheaven.com/clues/exam-part-sometimes
Writing assignment	crosswordheaven.com/clues/writing-assignment
Exam type	crosswordheaven.com/clues/exam-type
Gore Vidal piece	crosswordheaven.com/clues/gore-vidal-piece
''How I Spent My Summer Vacation,'' maybe	crosswordheaven.com/clues/how-i-spent-my-summer-vacation-maybe
Op-Ed article	crosswordheaven.com/clues/op-ed-article
Certain English assignment	crosswordheaven.com/clues/certain-english-assignment
English test requirement, often	crosswordheaven.com/clues/english-test-requirement-often
English exam, often	crosswordheaven.com/clues/english-exam-often
Thoreau's "Civil Disobedience," for one	crosswordheaven.com/clues/thoreaus-civil-disobedience-for-one
Susan Sontag piece	crosswordheaven.com/clues/susan-sontag-piece
Alternative to multiple choice	crosswordheaven.com/clues/alternative-to-multiple-choice
Type of test	crosswordheaven.com/clues/type-of-test
Alexander Pope piece	crosswordheaven.com/clues/alexander-pope-piece
The Atlantic piece	crosswordheaven.com/clues/the-atlantic-piece
Virginia Woolf piece	crosswordheaven.com/clues/virginia-woolf-piece
Written analysis	crosswordheaven.com/clues/written-analysis
Personal prose unit	crosswordheaven.com/clues/personal-prose-unit
Ralph Waldo Emerson piece	crosswordheaven.com/clues/ralph-waldo-emerson-piece
Literary composition	crosswordheaven.com/clues/literary-composition
Test segment, perhaps	crosswordheaven.com/clues/test-segment-perhaps
English test, sometimes	crosswordheaven.com/clues/english-test-sometimes
Give it a shot	crosswordheaven.com/clues/give-it-a-shot
English 101 assignment	crosswordheaven.com/clues/english-101-assignment
"How I Spent My Summer Vacation," e.g.	crosswordheaven.com/clues/how-i-spent-my-summer-vacation-eg
"How I Spent My Summer Vacation" e.g.	crosswordheaven.com/clues/how-i-spent-my-summer-vacation-eg
Magazine piece, sometimes	crosswordheaven.com/clues/magazine-piece-sometimes
Piece of prose	crosswordheaven.com/clues/piece-of-prose
Part of some exams	crosswordheaven.com/clues/part-of-some-exams
Emerson opus	crosswordheaven.com/clues/emerson-opus
Composition	crosswordheaven.com/clues/composition
Test format, sometimes	crosswordheaven.com/clues/test-format-sometimes
Lengthy test answer	crosswordheaven.com/clues/lengthy-test-answer
English final exam, perhaps	crosswordheaven.com/clues/english-final-exam-perhaps
Contest entry	crosswordheaven.com/clues/contest-entry
College application piece, perhaps	crosswordheaven.com/clues/college-application-piece-perhaps
Montaigne piece	crosswordheaven.com/clues/montaigne-piece
Long-form writing assignment	crosswordheaven.com/clues/long-form-writing-assignment
SAT segment	crosswordheaven.com/clues/sat-segment
Article in Harper's	crosswordheaven.com/clues/article-in-harpers
Test composition	crosswordheaven.com/clues/test-composition
Paper piece	crosswordheaven.com/clues/paper-piece
Charles Lamb piece	crosswordheaven.com/clues/charles-lamb-piece
Blue-book composition	crosswordheaven.com/clues/blue-book-composition
Piece of schoolwork	crosswordheaven.com/clues/piece-of-schoolwork
Op-ed piece, usually	crosswordheaven.com/clues/op-ed-piece-usually
English composition	crosswordheaven.com/clues/english-composition
Short piece of writing	crosswordheaven.com/clues/short-piece-of-writing
History class assignment	crosswordheaven.com/clues/history-class-assignment
Common college admissions requirement	crosswordheaven.com/clues/common-college-admissions-requirement
Long English assignment	crosswordheaven.com/clues/long-english-assignment
Emersonian effort	crosswordheaven.com/clues/emersonian-effort
Exam portion, perhaps	crosswordheaven.com/clues/exam-portion-perhaps
College application component	crosswordheaven.com/clues/college-application-component
It has a point	crosswordheaven.com/clues/it-has-a-point
"Civil Disobedience" is one	crosswordheaven.com/clues/civil-disobedience-is-one
English homework, perhaps	crosswordheaven.com/clues/english-homework-perhaps
Bit of literature	crosswordheaven.com/clues/bit-of-literature
College application requirement, often	crosswordheaven.com/clues/college-application-requirement-often
Analytic writing	crosswordheaven.com/clues/analytic-writing
"How I Spent My Summer," often	crosswordheaven.com/clues/how-i-spent-my-summer-often
Type of question	crosswordheaven.com/clues/type-of-question
Student's assignment	crosswordheaven.com/clues/students-assignment
George Will piece	crosswordheaven.com/clues/george-will-piece
English homework, maybe	crosswordheaven.com/clues/english-homework-maybe
School paper	crosswordheaven.com/clues/school-paper
Exam format	crosswordheaven.com/clues/exam-format
English homework, often	crosswordheaven.com/clues/english-homework-often
Elia writing	crosswordheaven.com/clues/elia-writing
Lamb writing	crosswordheaven.com/clues/lamb-writing
SAT section	crosswordheaven.com/clues/sat-section
Pope work	crosswordheaven.com/clues/pope-work
Thoreau piece	crosswordheaven.com/clues/thoreau-piece
Elia piece	crosswordheaven.com/clues/elia-piece
With 11-Down, blue-book exam	crosswordheaven.com/clues/with-11-down-blue-book-exam
Steele work	crosswordheaven.com/clues/steele-work
Dryden work	crosswordheaven.com/clues/dryden-work
History test section, often	crosswordheaven.com/clues/history-test-section-often
Lamb work	crosswordheaven.com/clues/lamb-work
Longish blog post	crosswordheaven.com/clues/longish-blog-post
History test component	crosswordheaven.com/clues/history-test-component
Five-paragraph piece, perhaps	crosswordheaven.com/clues/five-paragraph-piece-perhaps
Frank Rich piece	crosswordheaven.com/clues/frank-rich-piece
Short story	crosswordheaven.com/clues/short-story
Nora Ephron work	crosswordheaven.com/clues/nora-ephron-work
College application need	crosswordheaven.com/clues/college-application-need
55 Down portion, often	crosswordheaven.com/clues/55-down-portion-often
Final exam, maybe	crosswordheaven.com/clues/final-exam-maybe
Twain piece	crosswordheaven.com/clues/twain-piece
English test segment, perhaps	crosswordheaven.com/clues/english-test-segment-perhaps
Maureen Dowd piece	crosswordheaven.com/clues/maureen-dowd-piece
Locke work	crosswordheaven.com/clues/locke-work
Dreaded assingment	crosswordheaven.com/clues/dreaded-assingment
Part of many a college application	crosswordheaven.com/clues/part-of-many-a-college-application
Lamb creation	crosswordheaven.com/clues/lamb-creation
Bacon piece?	crosswordheaven.com/clues/bacon-piece
Opinion piece	http://www.crosswordgiant.com/crossword-clue/196230/Opinion-piece
School paper	http://www.crosswordgiant.com/crossword-clue/242598/School-paper
Literary composition	http://www.crosswordgiant.com/crossword-clue/246200/Literary-composition
Op-ed piece	http://www.crosswordgiant.com/crossword-clue/107662/Op-ed-piece
Homework assignment	http://www.crosswordgiant.com/crossword-clue/294374/Homework-assignment
English composition	http://www.crosswordgiant.com/crossword-clue/530274/English-composition
Writing assignment	http://www.crosswordgiant.com/crossword-clue/138668/Writing-assignment
English-class assignment	http://www.crosswordgiant.com/crossword-clue/276424/English-class-assignment
School assignment	http://www.crosswordgiant.com/crossword-clue/33503/School-assignment
Test type	http://www.crosswordgiant.com/crossword-clue/44595/Test-type
Emerson work	http://www.crosswordgiant.com/crossword-clue/73052/Emerson-work
English assignment	http://www.crosswordgiant.com/crossword-clue/229221/English-assignment
Prose piece	http://www.crosswordgiant.com/crossword-clue/298855/Prose-piece
Bacon product	http://www.crosswordgiant.com/crossword-clue/41964/Bacon-product
Lamb piece	http://www.crosswordgiant.com/crossword-clue/337557/Lamb-piece
Written composition	http://www.crosswordgiant.com/crossword-clue/627277/Written-composition
Blue book filler	http://www.crosswordgiant.com/crossword-clue/6202/Blue-book-filler
Composition	http://www.crosswordgiant.com/crossword-clue/140292/Composition
English homework, maybe	http://www.crosswordgiant.com/crossword-clue/223894/English-homework-maybe
Think piece	http://www.crosswordgiant.com/crossword-clue/463052/Think-piece
English class assignment	http://www.crosswordgiant.com/crossword-clue/470425/English-class-assignment
College application part	http://www.crosswordgiant.com/crossword-clue/641605/College-application-part
Make an effort to write one	http://www.crosswordgiant.com/crossword-clue/981568/Make-an-effort-to-write-one
Attempt	http://www.crosswordgiant.com/crossword-clue/4176/Attempt
Test format	http://www.crosswordgiant.com/crossword-clue/183517/Test-format
Lengthy test answer	http://www.crosswordgiant.com/crossword-clue/259428/Lengthy-test-answer
Writing class assignment	http://www.crosswordgiant.com/crossword-clue/719109/Writing-class-assignment
Try	http://www.crosswordgiant.com/crossword-clue/12878/Try
Lamb product	http://www.crosswordgiant.com/crossword-clue/25151/Lamb-product
Calvin Trillin piece	http://www.crosswordgiant.com/crossword-clue/27047/Calvin-Trillin-piece
Swift work	http://www.crosswordgiant.com/crossword-clue/39991/Swift-work
''Civil Disobedience,'' e.g.	http://www.crosswordgiant.com/crossword-clue/114733/Civil-Disobedience-e.g
Piece of Bacon?	http://www.crosswordgiant.com/crossword-clue/117795/Piece-of-Bacon
English test, perhaps	http://www.crosswordgiant.com/crossword-clue/160277/English-test-perhaps
Bacon bit?	http://www.crosswordgiant.com/crossword-clue/177580/Bacon-bit
"How I Spent My Summer Vacation," maybe	http://www.crosswordgiant.com/crossword-clue/210512/How-I-Spent-My-Summer-Vacation-maybe
Op-ed piece, e.g.	http://www.crosswordgiant.com/crossword-clue/274796/Op-ed-piece-e.g
Test format, sometimes	http://www.crosswordgiant.com/crossword-clue/275359/Test-format-sometimes
English homework	http://www.crosswordgiant.com/crossword-clue/334753/English-homework
Blue book entry	http://www.crosswordgiant.com/crossword-clue/494133/Blue-book-entry
Blue-book composition	http://www.crosswordgiant.com/crossword-clue/887254/Blue-book-composition
Literary composition	http://www.crosswordgiant.com/crossword-clue/1022558/Literarycomposition
Opinionated work	http://www.crosswordgiant.com/crossword-clue/21536/Opinionated-work
Time piece?	http://www.crosswordgiant.com/crossword-clue/50861/Time-piece
English exam finale, often	http://www.crosswordgiant.com/crossword-clue/66298/English-exam-finale-often
Piece in Harper's	http://www.crosswordgiant.com/crossword-clue/67927/Piece-in-Harpers
Blue-book filler	http://www.crosswordgiant.com/crossword-clue/70857/Blue-book-filler
Bacon piece	http://www.crosswordgiant.com/crossword-clue/72724/Bacon-piece
Emerson product	http://www.crosswordgiant.com/crossword-clue/120556/Emerson-product
Exam type	http://www.crosswordgiant.com/crossword-clue/148710/Exam-type
English test requirement	http://www.crosswordgiant.com/crossword-clue/185537/English-test-requirement
"Civil Disobedience," e.g.	http://www.crosswordgiant.com/crossword-clue/225685/Civil-Disobedience-e.g
Gore Vidal piece	http://www.crosswordgiant.com/crossword-clue/231968/Gore-Vidal-piece
Lamb specialty	http://www.crosswordgiant.com/crossword-clue/236538/Lamb-specialty
Composition with a viewpoint	http://www.crosswordgiant.com/crossword-clue/240807/Composition-with-a-viewpoint
Virginia Woolf piece	http://www.crosswordgiant.com/crossword-clue/263520/Virginia-Woolf-piece
SAT section	http://www.crosswordgiant.com/crossword-clue/264054/SAT-section
English test requirement, often	http://www.crosswordgiant.com/crossword-clue/271896/English-test-requirement-often
Pope piece	http://www.crosswordgiant.com/crossword-clue/283356/Pope-piece
Piece in The New Republic	http://www.crosswordgiant.com/crossword-clue/314737/Piece-in-The-New-Republic
English 101 assignment	http://www.crosswordgiant.com/crossword-clue/325597/English-101-assignment
    Bacon piece	http://www.crosswordgiant.com/crossword-clue/325896/-Bacon-piece
''How I Spent My Summer Vacation,'' maybe	http://www.crosswordgiant.com/crossword-clue/338492/How-I-Spent-My-Summer-Vacation-maybe
Samuel Johnson work	http://www.crosswordgiant.com/crossword-clue/347203/Samuel-Johnson-work
Certain English assignment	http://www.crosswordgiant.com/crossword-clue/375788/Certain-English-assignment
High-school composition	http://www.crosswordgiant.com/crossword-clue/376071/High-school-composition
The New Yorker piece	http://www.crosswordgiant.com/crossword-clue/426747/The-New-Yorker-piece
School composition	http://www.crosswordgiant.com/crossword-clue/454891/School-composition
Analytic work	http://www.crosswordgiant.com/crossword-clue/532049/Analytic-work
English homework, often	http://www.crosswordgiant.com/crossword-clue/580043/English-homework-often
Feature in Harper's or The Atlantic	http://www.crosswordgiant.com/crossword-clue/594588/Feature-in-Harpers-or-The-Atlantic
Alexander Pope piece	http://www.crosswordgiant.com/crossword-clue/629753/Alexander-Pope-piece
Blog entry, maybe	http://www.crosswordgiant.com/crossword-clue/682635/Blog-entry-maybe
Part of a college application	http://www.crosswordgiant.com/crossword-clue/724166/Part-of-a-college-application
Make an effort or attempt	http://www.crosswordgiant.com/crossword-clue/974975/Make-an-effort-or-attempt
Short formal piece of writing	http://www.crosswordgiant.com/crossword-clue/1037168/Short-formal-piece-of-writing
Try to put it in writing	http://www.crosswordgiant.com/crossword-clue/1173739/Try-to-put-it-in-writing
Bit of literature	http://www.crosswordgiant.com/crossword-clue/1201522/Bit-of-literature
"How I Spent My Summer," often	http://www.crosswordgiant.com/crossword-clue/1206363/How-I-Spent-My-Summer-often
Homework, perhaps, heads of school always read aloud	http://www.crosswordgiant.com/crossword-clue/1272963/Homework-perhaps-heads-of-school-always-read-aloud
Attempt - piece of writing	http://www.crosswordgiant.com/crossword-clue/1374724/Attempt-piece-of-writing
Montaigne's writing form	http://www.crosswordgiant.com/crossword-clue/1441105/Montaignes-writing-form
English test segment, perhaps	http://www.crosswordgiant.com/crossword-clue/1454176/English-test-segment-perhaps
16-Across work	http://www.crosswordgiant.com/crossword-clue/33071/16-Across-work
'Civil Disobedience,' e.g.	http://www.crosswordgiant.com/crossword-clue/39130/Civil-Disobedience-e.g
Article in Harper's or The Atlantic	http://www.crosswordgiant.com/crossword-clue/61273/Article-in-Harpers-or-The-Atlantic
'How I Spent My Summer Vacation,' maybe	http://www.crosswordgiant.com/crossword-clue/82383/How-I-Spent-My-Summer-Vacation-maybe
It has a point	http://www.crosswordgiant.com/crossword-clue/82441/It-has-a-point
Paper	http://www.crosswordgiant.com/crossword-clue/83092/Paper
Endeavor	http://www.crosswordgiant.com/crossword-clue/117569/Endeavor
Homework assignment, sometimes	http://www.crosswordgiant.com/crossword-clue/124251/Homework-assignment-sometimes
Schoolboy's grammatical exercise	http://www.crosswordgiant.com/crossword-clue/133328/Schoolboys-grammatical-exercise
Swift's ''A Modest Proposal,'' e.g.	http://www.crosswordgiant.com/crossword-clue/138380/Swifts-A-Modest-Proposal-e.g
Emerson's ''Self-Reliance,'' for one	http://www.crosswordgiant.com/crossword-clue/139246/Emersons-Self-Reliance-for-one
Piece of Lamb or Bacon	http://www.crosswordgiant.com/crossword-clue/147552/Piece-of-Lamb-or-Bacon
Homework assignment in English, often	http://www.crosswordgiant.com/crossword-clue/150151/Homework-assignment-in-English-often
Lamb 's tale	http://www.crosswordgiant.com/crossword-clue/150835/Lamb-s-tale
Emerson piece	http://www.crosswordgiant.com/crossword-clue/179041/Emerson-piece
Take a crack at	http://www.crosswordgiant.com/crossword-clue/181713/Take-a-crack-at
'A Modest Proposal,' e.g.	http://www.crosswordgiant.com/crossword-clue/183217/A-Modest-Proposal-e.g
Type of test	http://www.crosswordgiant.com/crossword-clue/186557/Type-of-test
Theme	http://www.crosswordgiant.com/crossword-clue/192994/Theme
E. B. White piece	http://www.crosswordgiant.com/crossword-clue/194304/E.-B.-White-piece
Very long-winded answer	http://www.crosswordgiant.com/crossword-clue/201381/Very-long-winded-answer
"A Modest Proposal" e.g.	http://www.crosswordgiant.com/crossword-clue/203055/A-Modest-Proposal-e.g
Paper piece	http://www.crosswordgiant.com/crossword-clue/204775/Paper-piece
Bacon product?	http://www.crosswordgiant.com/crossword-clue/204877/Bacon-product
College applicant's creation	http://www.crosswordgiant.com/crossword-clue/216165/College-applicants-creation
Exam format	http://www.crosswordgiant.com/crossword-clue/217710/Exam-format
"How I Spent My Summer Vacation" e.g.	http://www.crosswordgiant.com/crossword-clue/226561/How-I-Spent-My-Summer-Vacation-e.g
Bacon or Lamb product	http://www.crosswordgiant.com/crossword-clue/253681/Bacon-or-Lamb-product
Give it a shot	http://www.crosswordgiant.com/crossword-clue/255275/Give-it-a-shot
Test assignment, sometimes	http://www.crosswordgiant.com/crossword-clue/255937/Test-assignment-sometimes
Blue-book filler, perhaps	http://www.crosswordgiant.com/crossword-clue/264796/Blue-book-filler-perhaps
W.E.B. Du Bois work	http://www.crosswordgiant.com/crossword-clue/268611/W.E.B.-Du-Bois-work
Maureen Dowd piece	http://www.crosswordgiant.com/crossword-clue/272661/Maureen-Dowd-piece
"How I Spent My Summer Vacation," e.g.	http://www.crosswordgiant.com/crossword-clue/287941/How-I-Spent-My-Summer-Vacation-e.g
Test segment, perhaps	http://www.crosswordgiant.com/crossword-clue/294938/Test-segment-perhaps
Test format, perhaps	http://www.crosswordgiant.com/crossword-clue/306919/Test-format-perhaps
English test, sometimes	http://www.crosswordgiant.com/crossword-clue/307754/English-test-sometimes
Journal submission	http://www.crosswordgiant.com/crossword-clue/308824/Journal-submission
Bacon bit	http://www.crosswordgiant.com/crossword-clue/323649/Bacon-bit
Pope work	http://www.crosswordgiant.com/crossword-clue/339302/Pope-work
Ralph Waldo Emerson piece	http://www.crosswordgiant.com/crossword-clue/363183/Ralph-Waldo-Emerson-piece
English test component	http://www.crosswordgiant.com/crossword-clue/368512/English-test-component
Common college admission requirement	http://www.crosswordgiant.com/crossword-clue/372450/Common-college-admission-requirement
School assignment, perhaps	http://www.crosswordgiant.com/crossword-clue/375800/School-assignment-perhaps
Make an attempt	http://www.crosswordgiant.com/crossword-clue/379707/Make-an-attempt
Literary work	http://www.crosswordgiant.com/crossword-clue/384208/Literary-work
Pundit's piece	http://www.crosswordgiant.com/crossword-clue/392793/Pundits-piece
History homework, sometimes	http://www.crosswordgiant.com/crossword-clue/398803/History-homework-sometimes
With 11-Down, blue-book exam	http://www.crosswordgiant.com/crossword-clue/403925/With-11-Down-blue-book-exam
Emersonian effort	http://www.crosswordgiant.com/crossword-clue/438225/Emersonian-effort
Test you can't really guess on	http://www.crosswordgiant.com/crossword-clue/441169/Test-you-cant-really-guess-on
Calvin Trillin piece, perhaps	http://www.crosswordgiant.com/crossword-clue/463869/Calvin-Trillin-piece-perhaps
Thoreau piece	http://www.crosswordgiant.com/crossword-clue/475973/Thoreau-piece
Question type	http://www.crosswordgiant.com/crossword-clue/477447/Question-type
Class paper	http://www.crosswordgiant.com/crossword-clue/477479/Class-paper
Op-ed column, e.g.	http://www.crosswordgiant.com/crossword-clue/478942/Op-ed-column-e.g
Addison and Steele piece	http://www.crosswordgiant.com/crossword-clue/482977/Addison-and-Steele-piece
Exam part, sometimes	http://www.crosswordgiant.com/crossword-clue/494920/Exam-part-sometimes
Elia piece	http://www.crosswordgiant.com/crossword-clue/496200/Elia-piece
Expository writing class assignment	http://www.crosswordgiant.com/crossword-clue/500768/Expository-writing-class-assignment
The Atlantic piece	http://www.crosswordgiant.com/crossword-clue/508883/The-Atlantic-piece
Op-ed, typically	http://www.crosswordgiant.com/crossword-clue/513460/Op-ed-typically
Samuel Johnson's "The False Alarm," e.g.	http://www.crosswordgiant.com/crossword-clue/513969/Samuel-Johnsons-The-False-Alarm-e.g
Social Studies assignment	http://www.crosswordgiant.com/crossword-clue/514511/Social-Studies-assignment
Test that's tough to cheat on	http://www.crosswordgiant.com/crossword-clue/531228/Test-thats-tough-to-cheat-on
SAT part	http://www.crosswordgiant.com/crossword-clue/543134/SAT-part
Editorial piece	http://www.crosswordgiant.com/crossword-clue/547238/Editorial-piece
Written analysis	http://www.crosswordgiant.com/crossword-clue/552259/Written-analysis
Treatise	http://www.crosswordgiant.com/crossword-clue/554107/Treatise
Personal prose unit	http://www.crosswordgiant.com/crossword-clue/557839/Personal-prose-unit
Test section, often	http://www.crosswordgiant.com/crossword-clue/558134/Test-section-often
Op-Ed article	http://www.crosswordgiant.com/crossword-clue/558182/Op-Ed-article
Lamb or Bacon piece	http://www.crosswordgiant.com/crossword-clue/581896/Lamb-or-Bacon-piece
National Review piece	http://www.crosswordgiant.com/crossword-clue/584235/National-Review-piece
Swift's 'A Modest Proposal,' e.g.	http://www.crosswordgiant.com/crossword-clue/601700/Swifts-A-Modest-Proposal-e.g
Written test type	http://www.crosswordgiant.com/crossword-clue/611853/Written-test-type
High-school exam part	http://www.crosswordgiant.com/crossword-clue/618866/High-school-exam-part
Alternative to multiple choice	http://www.crosswordgiant.com/crossword-clue/618922/Alternative-to-multiple-choice
Piece with a point (5)	http://www.crosswordgiant.com/crossword-clue/630284/Piece-with-a-point-5
English paper	http://www.crosswordgiant.com/crossword-clue/634187/English-paper
Five-paragraph response, perhaps	http://www.crosswordgiant.com/crossword-clue/642387/Five-paragraph-response-perhaps
Part of many a history test	http://www.crosswordgiant.com/crossword-clue/648075/Part-of-many-a-history-test
Writing contest entry, often	http://www.crosswordgiant.com/crossword-clue/658334/Writing-contest-entry-often
Susan Sontag piece	http://www.crosswordgiant.com/crossword-clue/673569/Susan-Sontag-piece
Thoreau's ''Civil Disobedience,'' for one	http://www.crosswordgiant.com/crossword-clue/680733/Thoreaus-Civil-Disobedience-for-one
English exam, often	http://www.crosswordgiant.com/crossword-clue/687595/English-exam-often
Test question, maybe	http://www.crosswordgiant.com/crossword-clue/699618/Test-question-maybe
"A literary device for saying almost everything about almost anything": Huxley	http://www.crosswordgiant.com/crossword-clue/703609/A-literary-device-for-saying-almost-everything-about-almost-anything-Huxley
Test answer, maybe	http://www.crosswordgiant.com/crossword-clue/707496/Test-answer-maybe
Student's composition	http://www.crosswordgiant.com/crossword-clue/719345/Students-composition
English homework, perhaps	http://www.crosswordgiant.com/crossword-clue/739350/English-homework-perhaps
Five-paragraph assignment, perhaps	http://www.crosswordgiant.com/crossword-clue/747368/Five-paragraph-assignment-perhaps
Long test answer	http://www.crosswordgiant.com/crossword-clue/762938/Long-test-answer
"The Federalist" component	http://www.crosswordgiant.com/crossword-clue/776638/The-Federalist-component
Piece of prose	http://www.crosswordgiant.com/crossword-clue/779933/Piece-of-prose
Part of a social studies test	http://www.crosswordgiant.com/crossword-clue/781864/Part-of-a-social-studies-test
Exam type you can't guess on	http://www.crosswordgiant.com/crossword-clue/783789/Exam-type-you-cant-guess-on
Part of some exams	http://www.crosswordgiant.com/crossword-clue/787837/Part-of-some-exams
Prose composition	http://www.crosswordgiant.com/crossword-clue/794471/Prose-composition
Magazine piece, sometimes	http://www.crosswordgiant.com/crossword-clue/801427/Magazine-piece-sometimes
Student's composition	http://www.crosswordgiant.com/crossword-clue/802849/Students-composition
Emerson opus	http://www.crosswordgiant.com/crossword-clue/804148/Emerson-opus
College application component	http://www.crosswordgiant.com/crossword-clue/816784/College-application-component
Blue book test answer	http://www.crosswordgiant.com/crossword-clue/830388/Blue-book-test-answer
Contest entry	http://www.crosswordgiant.com/crossword-clue/849569/Contest-entry
Montaigne piece	http://www.crosswordgiant.com/crossword-clue/860506/Montaigne-piece
Long-form writing assignment	http://www.crosswordgiant.com/crossword-clue/862233/Long-form-writing-assignment
SAT segment	http://www.crosswordgiant.com/crossword-clue/865433/SAT-segment
Article in Harper's	http://www.crosswordgiant.com/crossword-clue/869798/Article-in-Harpers
Test composition	http://www.crosswordgiant.com/crossword-clue/871162/Test-composition
Charles Lamb piece	http://www.crosswordgiant.com/crossword-clue/876729/Charles-Lamb-piece
Part of the SAT	http://www.crosswordgiant.com/crossword-clue/878114/Part-of-the-SAT
Elia writing	http://www.crosswordgiant.com/crossword-clue/882578/Elia-writing
Piece of schoolwork	http://www.crosswordgiant.com/crossword-clue/888028/Piece-of-schoolwork
Lamb writing	http://www.crosswordgiant.com/crossword-clue/901659/Lamb-writing
History class assignment	http://www.crosswordgiant.com/crossword-clue/906129/History-class-assignment
Long English assignment	http://www.crosswordgiant.com/crossword-clue/906397/Long-English-assignment
Common college admissions requirement	http://www.crosswordgiant.com/crossword-clue/906411/Common-college-admissions-requirement
Exam portion, perhaps	http://www.crosswordgiant.com/crossword-clue/911704/Exam-portion-perhaps
Thoreau composition	http://www.crosswordgiant.com/crossword-clue/916553/Thoreau-composition
"Civil Disobedience" is one	http://www.crosswordgiant.com/crossword-clue/925442/Civil-Disobedience-is-one
Analytic or interpretive literary composition (5_	http://www.crosswordgiant.com/crossword-clue/974293/Analytic-or-interpretive-literary-composition-5_
School compeosition	http://www.crosswordgiant.com/crossword-clue/982919/School-compeosition
Try for a composition	http://www.crosswordgiant.com/crossword-clue/986421/Try-for-a-composition
Composition, paper, article	http://www.crosswordgiant.com/crossword-clue/987873/Composition-paper-article
Make an effort, to write one?	http://www.crosswordgiant.com/crossword-clue/998071/Make-an-effort-to-write-one
Article, paper	http://www.crosswordgiant.com/crossword-clue/1013508/Article-paper
Have a shot at a written piece	http://www.crosswordgiant.com/crossword-clue/1017156/Have-a-shot-at-a-written-piece
'E is the one to speak of this attempt of writing	http://www.crosswordgiant.com/crossword-clue/1065265/E-is-the-one-to-speak-of-this-attempt-of-writing
E's to speak it, or write it, or try to	http://www.crosswordgiant.com/crossword-clue/1075493/Es-to-speak-it-or-write-it-or-try-to
Sounds as if the S.A. is in there. Yes, and it's about S.A. too	http://www.crosswordgiant.com/crossword-clue/1108211/Sounds-as-if-the-S.A.-is-in-there.-Yes-and-its-about-S.A.-too
Try to write it or speak it at last	http://www.crosswordgiant.com/crossword-clue/1118756/Try-to-write-it-or-speak-it-at-last
Just try to put it in writing	http://www.crosswordgiant.com/crossword-clue/1140563/Just-try-to-put-it-in-writing
Try writing to speak at last	http://www.crosswordgiant.com/crossword-clue/1163988/Try-writing-to-speak-at-last
Try to put the writing into words at last	http://www.crosswordgiant.com/crossword-clue/1169106/Try-to-put-the-writing-into-words-at-last
What the 11 down may try to produce	http://www.crosswordgiant.com/crossword-clue/1203945/What-the-11-down-may-try-to-produce
Swift's "A Modest Proposal," e.g	http://www.crosswordgiant.com/crossword-clue/1211190/Swifts-A-Modest-Proposal-e.g
Long answer on a test	http://www.crosswordgiant.com/crossword-clue/1212278/Long-answer-on-a-test
Persuasive piece	http://www.crosswordgiant.com/crossword-clue/1225634/Persuasive-piece
Steele work	http://www.crosswordgiant.com/crossword-clue/1234884/Steele-work
"A Modest Proposal," e.g	http://www.crosswordgiant.com/crossword-clue/1240403/A-Modest-Proposal-e.g
Try a piece of bacon or lamb	http://www.crosswordgiant.com/crossword-clue/1248010/Try-a-piece-of-bacon-or-lamb
History test section, often	http://www.crosswordgiant.com/crossword-clue/1253980/History-test-section-often
Lamb work	http://www.crosswordgiant.com/crossword-clue/1255709/Lamb-work
Longish blog post	http://www.crosswordgiant.com/crossword-clue/1256126/Longish-blog-post
Try writing	http://www.crosswordgiant.com/crossword-clue/1262028/Try-writing
Writing speech on South Africa	http://www.crosswordgiant.com/crossword-clue/1314571/Writing-speech-on-South-Africa
Writing, having points to express	http://www.crosswordgiant.com/crossword-clue/1322516/Writing-having-points-to-express
Try some Bacon or Lamb?	http://www.crosswordgiant.com/crossword-clue/1344523/Try-some-Bacon-or-Lamb
Composition ã try	http://www.crosswordgiant.com/crossword-clue/1352282/Composition-try
Try - composition	http://www.crosswordgiant.com/crossword-clue/1358198/Try-composition
Written academic work	http://www.crosswordgiant.com/crossword-clue/1388602/Written-academic-work
Attempt â€” written work	http://www.crosswordgiant.com/crossword-clue/1399667/Attempt-written-work
College application piece, perhaps	http://www.crosswordgiant.com/crossword-clue/1417467/College-application-piece-perhaps
History test component	http://www.crosswordgiant.com/crossword-clue/1422539/History-test-component
Five-paragraph piece, perhaps	http://www.crosswordgiant.com/crossword-clue/1423463/Five-paragraph-piece-perhaps
Frank Rich piece	http://www.crosswordgiant.com/crossword-clue/1425387/Frank-Rich-piece
Nora Ephron work	http://www.crosswordgiant.com/crossword-clue/1428628/Nora-Ephron-work
College application need	http://www.crosswordgiant.com/crossword-clue/1439642/College-application-need
55 Down portion, often	http://www.crosswordgiant.com/crossword-clue/1449320/55-Down-portion-often
Twain piece	http://www.crosswordgiant.com/crossword-clue/1453597/Twain-piece
Locke work	http://www.crosswordgiant.com/crossword-clue/1462966/Locke-work
Part of many a college application	http://www.crosswordgiant.com/crossword-clue/1465640/Part-of-many-a-college-application
Lamb creation	http://www.crosswordgiant.com/crossword-clue/1467913/Lamb-creation
"The New Yorker" piece	http://www.crosswordgiant.com/crossword-clue/1474866/The-New-Yorker-piece
