Jumble	crosswordtracker.com/clue/jumble/
Diner order	crosswordtracker.com/clue/diner-order/
"American ___"	crosswordtracker.com/clue/american-___/
___-eyed	crosswordtracker.com/clue/___-eyed-1/
Bakery offering	crosswordtracker.com/clue/bakery-offering-1/
Key lime, e.g.	crosswordtracker.com/clue/key-lime-eg/
Bakery buy	crosswordtracker.com/clue/bakery-buy/
Dessert choice	crosswordtracker.com/clue/dessert-choice/
Sweet treat	crosswordtracker.com/clue/sweet-treat/
Fruity dessert	crosswordtracker.com/clue/fruity-dessert-1/
Christmas ___	crosswordtracker.com/clue/christmas-___/
Noisy bird	crosswordtracker.com/clue/noisy-bird/
Pizzeria order	crosswordtracker.com/clue/pizzeria-order/
Slapstick prop	crosswordtracker.com/clue/slapstick-prop/
Pizza order	crosswordtracker.com/clue/pizza-order/
Chart shape	crosswordtracker.com/clue/chart-shape/
Word after cutie or sweetie	crosswordtracker.com/clue/word-after-cutie-or-sweetie/
Symbol of easiness	crosswordtracker.com/clue/symbol-of-easiness/
Baked dessert	crosswordtracker.com/clue/baked-dessert/
All-American dessert	crosswordtracker.com/clue/all-american-dessert/
Clown's prop	crosswordtracker.com/clue/clowns-prop/
Type of chart	crosswordtracker.com/clue/type-of-chart/
Chart type	crosswordtracker.com/clue/chart-type/
Epitome of easiness	crosswordtracker.com/clue/epitome-of-easiness/
Kind of chart	crosswordtracker.com/clue/kind-of-chart/
Diner dessert	crosswordtracker.com/clue/diner-dessert/
Symbol of simplicity	crosswordtracker.com/clue/symbol-of-simplicity/
Graphic symbol	crosswordtracker.com/clue/graphic-symbol-1/
It may be humble	crosswordtracker.com/clue/it-may-be-humble/
Crusty dessert	crosswordtracker.com/clue/crusty-dessert/
Pizzeria purchase	crosswordtracker.com/clue/pizzeria-purchase/
Thanksgiving staple	crosswordtracker.com/clue/thanksgiving-staple/
Bakery purchase	crosswordtracker.com/clue/bakery-purchase/
Bakery goodie	crosswordtracker.com/clue/bakery-goodie/
Symbol of ease	crosswordtracker.com/clue/symbol-of-ease/
Easy as ___	crosswordtracker.com/clue/easy-as-___/
Diner staple	crosswordtracker.com/clue/diner-staple/
Thanksgiving serving	crosswordtracker.com/clue/thanksgiving-serving/
Sugar ___	crosswordtracker.com/clue/sugar-___-1/
Pandowdy	crosswordtracker.com/clue/pandowdy-1/
Patisserie purchase	crosswordtracker.com/clue/patisserie-purchase/
Bakery item	crosswordtracker.com/clue/bakery-item-1/
Fruit-filled dessert	crosswordtracker.com/clue/fruit-filled-dessert/
Slapstick missile	crosswordtracker.com/clue/slapstick-missile/
Bakery order	crosswordtracker.com/clue/bakery-order/
Slapstick projectile	crosswordtracker.com/clue/slapstick-projectile-1/
Slapstick staple	crosswordtracker.com/clue/slapstick-staple-1/
Pastry	crosswordtracker.com/clue/pastry-34/
Lemon meringue, for one	crosswordtracker.com/clue/lemon-meringue-for-one/
Thanksgiving dessert	crosswordtracker.com/clue/thanksgiving-dessert/
Exemplar of easiness	crosswordtracker.com/clue/exemplar-of-easiness/
Rhubarb, for one	crosswordtracker.com/clue/rhubarb-for-one/
Thanksgiving wedge	crosswordtracker.com/clue/thanksgiving-wedge/
Round dessert	crosswordtracker.com/clue/round-dessert/
Cobbler	crosswordtracker.com/clue/cobbler-34/
Chart inspiration	crosswordtracker.com/clue/chart-inspiration/
Mud concoction	crosswordtracker.com/clue/mud-concoction/
Dessert with a crust	crosswordtracker.com/clue/dessert-with-a-crust/
Shepherd's, for one	crosswordtracker.com/clue/shepherds-for-one/
Dessert option	crosswordtracker.com/clue/dessert-option/
Mississippi mud, e.g.	crosswordtracker.com/clue/mississippi-mud-eg/
Easy as __	crosswordtracker.com/clue/easy-as-__/
Thanksgiving finale	crosswordtracker.com/clue/thanksgiving-finale/
It's slapstick material	crosswordtracker.com/clue/its-slapstick-material/
Dessert order	crosswordtracker.com/clue/dessert-order/
Baked dish	crosswordtracker.com/clue/baked-dish/
Crusty one	crosswordtracker.com/clue/crusty-one/
Quiche, e.g.	crosswordtracker.com/clue/quiche-eg/
Bake sale offering	crosswordtracker.com/clue/bake-sale-offering-1/
Pizza	crosswordtracker.com/clue/pizza-53/
Something simple, supposedly	crosswordtracker.com/clue/something-simple-supposedly/
Boston cream or Key lime	crosswordtracker.com/clue/boston-cream-or-key-lime/
Three Stooges prop	crosswordtracker.com/clue/three-stooges-prop/
Trivial Pursuit piece	crosswordtracker.com/clue/trivial-pursuit-piece/
Pecan, e.g.	crosswordtracker.com/clue/pecan-eg/
Dessert often served Ã  la mode	crosswordtracker.com/clue/dessert-often-served-a-la-mode/
Comedy staple that goes "splat"	crosswordtracker.com/clue/comedy-staple-that-goes-splat/
DESSERT	crosswordtracker.com/clue/dessert-101/
Four-and-twenty blackbirds' place	crosswordtracker.com/clue/four-and-twenty-blackbirds-place/
Cake alternative	crosswordtracker.com/clue/cake-alternative/
Divisible whole, figuratively	crosswordtracker.com/clue/divisible-whole-figuratively/
Flaky dessert	crosswordtracker.com/clue/flaky-dessert/
Budget chart	crosswordtracker.com/clue/budget-chart/
Pizzeria staple	crosswordtracker.com/clue/pizzeria-staple/
Sliced dessert	crosswordtracker.com/clue/sliced-dessert/
Bake-off entry	crosswordtracker.com/clue/bake-off-entry/
Three Little Kittens' reward	crosswordtracker.com/clue/three-little-kittens-reward/
Word with cutie or sweetie	crosswordtracker.com/clue/word-with-cutie-or-sweetie/
It's easy	crosswordtracker.com/clue/its-easy-2/
Set of wedges?	crosswordtracker.com/clue/set-of-wedges/
It may have a filling filling	crosswordtracker.com/clue/it-may-have-a-filling-filling/
It often has an upper crust	crosswordtracker.com/clue/it-often-has-an-upper-crust/
Dainty dish of blackbirds	crosswordtracker.com/clue/dainty-dish-of-blackbirds/
Little Jack Horner's dessert	crosswordtracker.com/clue/little-jack-horners-dessert/
Custard creation	crosswordtracker.com/clue/custard-creation/
Kind of filling	crosswordtracker.com/clue/kind-of-filling/
Tin contents	crosswordtracker.com/clue/tin-contents/
It has some crust	crosswordtracker.com/clue/it-has-some-crust/
Amount to be divided	crosswordtracker.com/clue/amount-to-be-divided/
Crusty dish	crosswordtracker.com/clue/crusty-dish/
Pizzeria creation	crosswordtracker.com/clue/pizzeria-creation/
Mud ___	crosswordtracker.com/clue/mud-___/
Pizzeria output	crosswordtracker.com/clue/pizzeria-output/
Mincemeat dessert	crosswordtracker.com/clue/mincemeat-dessert/
Order from Domino's	crosswordtracker.com/clue/order-from-dominos/
Word with sugar or cream	crosswordtracker.com/clue/word-with-sugar-or-cream/
Pandowdy, e.g.	crosswordtracker.com/clue/pandowdy-eg/
It has a shell	crosswordtracker.com/clue/it-has-a-shell/
Cobbler's cousin	crosswordtracker.com/clue/cobblers-cousin/
Jay's cousin	crosswordtracker.com/clue/jays-cousin-1/
___ Ã  la mode	crosswordtracker.com/clue/___-a-la-mode/
Tot's muddy concoction	crosswordtracker.com/clue/tots-muddy-concoction/
Bake sale item	crosswordtracker.com/clue/bake-sale-item/
Apple or blueberry	crosswordtracker.com/clue/apple-or-blueberry/
Dessert selection	crosswordtracker.com/clue/dessert-selection/
You might throw it in someone's face	crosswordtracker.com/clue/you-might-throw-it-in-someones-face/
Shoofly ___	crosswordtracker.com/clue/shoofly-___/
Dessert in the sky?	crosswordtracker.com/clue/dessert-in-the-sky/
Statistical metaphor	crosswordtracker.com/clue/statistical-metaphor/
Quiche shape	crosswordtracker.com/clue/quiche-shape/
Enterprise, figuratively	crosswordtracker.com/clue/enterprise-figuratively/
"National Velvet" horse, with "The"	crosswordtracker.com/clue/national-velvet-horse-with-the/
Sales chart metaphor	crosswordtracker.com/clue/sales-chart-metaphor/
Shoo-fly __	crosswordtracker.com/clue/shoo-fly-__/
Pizzeria offering	crosswordtracker.com/clue/pizzeria-offering/
Budget representation	crosswordtracker.com/clue/budget-representation/
What Jack Horner was eating	crosswordtracker.com/clue/what-jack-horner-was-eating/
Whole pizza	crosswordtracker.com/clue/whole-pizza/
Dessert-cart choice	crosswordtracker.com/clue/dessert-cart-choice/
Mock apple __	crosswordtracker.com/clue/mock-apple-__/
Eight slices, often	crosswordtracker.com/clue/eight-slices-often/
Dessert in a tin	crosswordtracker.com/clue/dessert-in-a-tin/
Pot attachment	crosswordtracker.com/clue/pot-attachment/
Graph shape	crosswordtracker.com/clue/graph-shape/
Something in a shell	crosswordtracker.com/clue/something-in-a-shell/
It may have a crimped crust	crosswordtracker.com/clue/it-may-have-a-crimped-crust/
Tin filler	crosswordtracker.com/clue/tin-filler/
Crusty treat	crosswordtracker.com/clue/crusty-treat/
Item often found cooling on a window sill	crosswordtracker.com/clue/item-often-found-cooling-on-a-window-sill/
Humble follower?	crosswordtracker.com/clue/humble-follower/
Word after sweetie or Tweety	crosswordtracker.com/clue/word-after-sweetie-or-tweety/
Word with cream or sugar	crosswordtracker.com/clue/word-with-cream-or-sugar/
Sky sight?	crosswordtracker.com/clue/sky-sight-3/
Financial chart metaphor	crosswordtracker.com/clue/financial-chart-metaphor/
Pastry choice	crosswordtracker.com/clue/pastry-choice/
Peach, cherry, or blueberry	crosswordtracker.com/clue/peach-cherry-or-blueberry/
Thanksgiving dessert, often	crosswordtracker.com/clue/thanksgiving-dessert-often/
Dessert favorite	crosswordtracker.com/clue/dessert-favorite/
Apple or peach, e.g.	crosswordtracker.com/clue/apple-or-peach-eg/
It can be eaten a la mode	crosswordtracker.com/clue/it-can-be-eaten-a-la-mode/
The horse in "National Velvet" (with "The")	crosswordtracker.com/clue/the-horse-in-national-velvet-with-the/
The three little kittens' reward	crosswordtracker.com/clue/the-three-little-kittens-reward/
Apple or banana cream	crosswordtracker.com/clue/apple-or-banana-cream/
Circular type of graph	crosswordtracker.com/clue/circular-type-of-graph/
Apple or cherry creation	crosswordtracker.com/clue/apple-or-cherry-creation/
Food for Jack Horner	crosswordtracker.com/clue/food-for-jack-horner/
Christmas dessert	crosswordtracker.com/clue/christmas-dessert/
Cobbler, for example	crosswordtracker.com/clue/cobbler-for-example/
Lure for Simple Simon	crosswordtracker.com/clue/lure-for-simple-simon/
A clown might get it in the face	crosswordtracker.com/clue/a-clown-might-get-it-in-the-face/
Something easy, supposedly	crosswordtracker.com/clue/something-easy-supposedly/
Representation of a budget, often	crosswordtracker.com/clue/representation-of-a-budget-often/
Trivial Pursuit goal	crosswordtracker.com/clue/trivial-pursuit-goal/
It may be served Ã  la mode	crosswordtracker.com/clue/it-may-be-served-a-la-mode/
Mincemeat ___	crosswordtracker.com/clue/mincemeat-___/
USA Today chart shape	crosswordtracker.com/clue/usa-today-chart-shape/
Missile from a prankster	crosswordtracker.com/clue/missile-from-a-prankster/
Goodie to be divided	crosswordtracker.com/clue/goodie-to-be-divided/
Domino's order	crosswordtracker.com/clue/dominos-order/
Organizational figure	crosswordtracker.com/clue/organizational-figure/
The horse in "National Velvet"	crosswordtracker.com/clue/the-horse-in-national-velvet-1/
Lemon meringue, e.g.	crosswordtracker.com/clue/lemon-meringue-eg/
Jack Horner's treat	crosswordtracker.com/clue/jack-horners-treat/
Eskimo ___	crosswordtracker.com/clue/eskimo-___-1/
Trivial Pursuit symbol	crosswordtracker.com/clue/trivial-pursuit-symbol/
Dessert that ties into the puzzle's theme	crosswordtracker.com/clue/dessert-that-ties-into-the-puzzles-theme/
Home to four-and-twenty blackbirds	crosswordtracker.com/clue/home-to-four-and-twenty-blackbirds/
Circular type of chart	crosswordtracker.com/clue/circular-type-of-chart/
Banana cream, for one	crosswordtracker.com/clue/banana-cream-for-one/
Chart choice	crosswordtracker.com/clue/chart-choice/
Mitten-finding kittens' reward	crosswordtracker.com/clue/mitten-finding-kittens-reward/
Cherry or pizza creation	crosswordtracker.com/clue/cherry-or-pizza-creation/
Apple or banana cream dessert	crosswordtracker.com/clue/apple-or-banana-cream-dessert/
It's often a la mode	crosswordtracker.com/clue/its-often-a-la-mode/
Dessert from an oven	crosswordtracker.com/clue/dessert-from-an-oven/
Comedic missile	crosswordtracker.com/clue/comedic-missile/
Ice cream go-with	crosswordtracker.com/clue/ice-cream-go-with/
Dessert in a pan	crosswordtracker.com/clue/dessert-in-a-pan/
"National Velvet" horse	crosswordtracker.com/clue/national-velvet-horse-1/
Humble follower	crosswordtracker.com/clue/humble-follower-1/
Epitome of easiness?	crosswordtracker.com/clue/epitome-of-easiness-1/
Quiche, essentially	crosswordtracker.com/clue/quiche-essentially/
Bit of Trivial Pursuit equipment	crosswordtracker.com/clue/bit-of-trivial-pursuit-equipment/
Something to go to a bakery for	crosswordtracker.com/clue/something-to-go-to-a-bakery-for/
Soupy Sales missile	crosswordtracker.com/clue/soupy-sales-missile/
USA Today chart	crosswordtracker.com/clue/usa-today-chart-1/
Sales pitch?	crosswordtracker.com/clue/sales-pitch-3/
Kind of tin	crosswordtracker.com/clue/kind-of-tin/
Item for Little Jack Horner	crosswordtracker.com/clue/item-for-little-jack-horner/
Prop in slapstick	crosswordtracker.com/clue/prop-in-slapstick/
Crusty one?	crosswordtracker.com/clue/crusty-one-2/
Cobbler, e.g.	crosswordtracker.com/clue/cobbler-eg/
Ã€ la mode serving	crosswordtracker.com/clue/a-la-mode-serving/
Dessert served in triangular slices	crosswordtracker.com/clue/dessert-served-in-triangular-slices/
Chart or plate preceder	crosswordtracker.com/clue/chart-or-plate-preceder/
Place for 24 blackbirds, in verse	crosswordtracker.com/clue/place-for-24-blackbirds-in-verse/
De la Mare's "Peacock ___"	crosswordtracker.com/clue/de-la-mares-peacock-___/
Flan, e.g.	crosswordtracker.com/clue/flan-eg/
Kind of bald?	crosswordtracker.com/clue/kind-of-bald/
Nesselrode or mud follower	crosswordtracker.com/clue/nesselrode-or-mud-follower/
Baseball's Traynor	crosswordtracker.com/clue/baseballs-traynor/
Eskimo_____	crosswordtracker.com/clue/eskimo_____/
Quiche Lorraine, e.g.	crosswordtracker.com/clue/quiche-lorraine-eg/
Lemon-meringue dessert	crosswordtracker.com/clue/lemon-meringue-dessert/
This may be in the sky	crosswordtracker.com/clue/this-may-be-in-the-sky/
Tart's cousin	crosswordtracker.com/clue/tarts-cousin/
Bird allied to a jay	crosswordtracker.com/clue/bird-allied-to-a-jay/
Item in the sky?	crosswordtracker.com/clue/item-in-the-sky/
Nesselrode, e.g.	crosswordtracker.com/clue/nesselrode-eg/
Cousin of a jay	crosswordtracker.com/clue/cousin-of-a-jay/
Something found in the sky	crosswordtracker.com/clue/something-found-in-the-sky/
One kind of crust	crosswordtracker.com/clue/one-kind-of-crust/
Operation time	crosswordtracker.com/clue/operation-time/
FishermanÂ’s hangout	crosswordtracker.com/clue/fishermans-hangout-1/
Dainty dish in "Sing a Song of Sixpence"	crosswordtracker.com/clue/dainty-dish-in-sing-a-song-of-sixpence/
Dessert menu item	crosswordtracker.com/clue/dessert-menu-item/
___ in the sky (empty wish)	crosswordtracker.com/clue/___-in-the-sky-empty-wish/
Tasty wedge	crosswordtracker.com/clue/tasty-wedge/
Budget chart shape	crosswordtracker.com/clue/budget-chart-shape/
Cap's counterpart	crosswordtracker.com/clue/caps-counterpart/
Mrs. Smith's offering	crosswordtracker.com/clue/mrs-smiths-offering/
Baseball Hall of Famer Traynor	crosswordtracker.com/clue/baseball-hall-of-famer-traynor/
Chart form	crosswordtracker.com/clue/chart-form/
"American ___" (1999 Jason Biggs movie)	crosswordtracker.com/clue/american-___-1999-jason-biggs-movie/
Hurled prop	crosswordtracker.com/clue/hurled-prop/
A kind of chart	crosswordtracker.com/clue/a-kind-of-chart/
Saskatoon berry treat	crosswordtracker.com/clue/saskatoon-berry-treat/
Chart genre	crosswordtracker.com/clue/chart-genre/
Pumpkin pastry	crosswordtracker.com/clue/pumpkin-pastry/
Apple or cherry e.g.	crosswordtracker.com/clue/apple-or-cherry-eg/
Word with sweetie or cutie	crosswordtracker.com/clue/word-with-sweetie-or-cutie/
Horner's dessert	crosswordtracker.com/clue/horners-dessert/
Reward for three little kittens	crosswordtracker.com/clue/reward-for-three-little-kittens/
Cherry or blueberry item	crosswordtracker.com/clue/cherry-or-blueberry-item/
Clown's missile	crosswordtracker.com/clue/clowns-missile/
It might be in the sky	crosswordtracker.com/clue/it-might-be-in-the-sky/
After-dinner fare	crosswordtracker.com/clue/after-dinner-fare/
Humble dessert?	crosswordtracker.com/clue/humble-dessert/
Type of tin	crosswordtracker.com/clue/type-of-tin/
Treat with a crust	crosswordtracker.com/clue/treat-with-a-crust/
Key lime or Dutch apple	crosswordtracker.com/clue/key-lime-or-dutch-apple/
Round food	crosswordtracker.com/clue/round-food-1/
Chart template	crosswordtracker.com/clue/chart-template/
Chart model	crosswordtracker.com/clue/chart-model/
Slapstick weapon	crosswordtracker.com/clue/slapstick-weapon/
Pizza parlor order	crosswordtracker.com/clue/pizza-parlor-order/
Dish that's a homonym for a number that relates to its shape	crosswordtracker.com/clue/dish-thats-a-homonym-for-a-number-that-relates-to-its-shape/
Shepherd's, e.g.	crosswordtracker.com/clue/shepherds-eg/
Hurled prop that might be made with shaving cream	crosswordtracker.com/clue/hurled-prop-that-might-be-made-with-shaving-cream/
Little Italy order	crosswordtracker.com/clue/little-italy-order/
Buster Keaton missile	crosswordtracker.com/clue/buster-keaton-missile/
Pizza	crosswordheaven.com/clues/pizza
USA Today chart	crosswordheaven.com/clues/usa-today-chart
Sales pitch?	crosswordheaven.com/clues/sales-pitch
It has a shell	crosswordheaven.com/clues/it-has-a-shell
Soupy Sales missile	crosswordheaven.com/clues/soupy-sales-missile
Pizzeria order	crosswordheaven.com/clues/pizzeria-order
Bit of Trivial Pursuit equipment	crosswordheaven.com/clues/bit-of-trivial-pursuit-equipment
Something to go to a bakery for	crosswordheaven.com/clues/something-to-go-to-a-bakery-for
Pandowdy, e.g.	crosswordheaven.com/clues/pandowdy-eg
Amount to be divided	crosswordheaven.com/clues/amount-to-be-divided
Kind of chart	crosswordheaven.com/clues/kind-of-chart
Cobbler	crosswordheaven.com/clues/cobbler
Item for Little Jack Horner	crosswordheaven.com/clues/item-for-little-jack-horner
Quiche, e.g.	crosswordheaven.com/clues/quiche-eg
Trivial Pursuit piece	crosswordheaven.com/clues/trivial-pursuit-piece
Kind of tin	crosswordheaven.com/clues/kind-of-tin
Sugar ___	crosswordheaven.com/clues/sugar-___
Symbol of simplicity	crosswordheaven.com/clues/symbol-of-simplicity
Prop in slapstick	crosswordheaven.com/clues/prop-in-slapstick
Cobbler, e.g.	crosswordheaven.com/clues/cobbler-eg
Epitome of easiness	crosswordheaven.com/clues/epitome-of-easiness
Crusty one?	crosswordheaven.com/clues/crusty-one
Dessert from an oven	crosswordheaven.com/clues/dessert-from-an-oven
Mud ___	crosswordheaven.com/clues/mud-___
Comedic missile	crosswordheaven.com/clues/comedic-missile
Order from Domino's	crosswordheaven.com/clues/order-from-dominos
Three Stooges prop	crosswordheaven.com/clues/three-stooges-prop
___-eyed	crosswordheaven.com/clues/___-eyed
Mincemeat dessert	crosswordheaven.com/clues/mincemeat-dessert
Pizzeria output	crosswordheaven.com/clues/pizzeria-output
Moon__ (sweet treat)	crosswordheaven.com/clues/moon__-sweet-treat
Ice cream go-with	crosswordheaven.com/clues/ice-cream-go-with
Dessert in a pan	crosswordheaven.com/clues/dessert-in-a-pan
Crusty dessert	crosswordheaven.com/clues/crusty-dessert
It may be humble	crosswordheaven.com/clues/it-may-be-humble
Chart type	crosswordheaven.com/clues/chart-type
"National Velvet" horse	crosswordheaven.com/clues/national-velvet-horse
Shoo-fly __	crosswordheaven.com/clues/shoo-fly-__
Slapstick prop	crosswordheaven.com/clues/slapstick-prop
Epitome of easiness?	crosswordheaven.com/clues/epitome-of-easiness
Word with sugar or cream	crosswordheaven.com/clues/word-with-sugar-or-cream
Humble follower	crosswordheaven.com/clues/humble-follower
Clown's prop	crosswordheaven.com/clues/clowns-prop
Chart shape	crosswordheaven.com/clues/chart-shape
With 13-Down, a diner order	crosswordheaven.com/clues/with-13-down-a-diner-order
Pizza order	crosswordheaven.com/clues/pizza-order
Thanksgiving serving	crosswordheaven.com/clues/thanksgiving-serving
Word with cutie or sweetie	crosswordheaven.com/clues/word-with-cutie-or-sweetie
It has some crust	crosswordheaven.com/clues/it-has-some-crust
Goodie to be divided	crosswordheaven.com/clues/goodie-to-be-divided
Mincemeat ___	crosswordheaven.com/clues/mincemeat-___
USA Today chart shape	crosswordheaven.com/clues/usa-today-chart-shape
It may be served Ã  la mode	crosswordheaven.com/clues/it-may-be-served-la-mode
Set of wedges?	crosswordheaven.com/clues/set-of-wedges
Christmas ___	crosswordheaven.com/clues/christmas-___
Easy as ___	crosswordheaven.com/clues/easy-as-___
Missile from a prankster	crosswordheaven.com/clues/missile-from-a-prankster
Bake sale offering	crosswordheaven.com/clues/bake-sale-offering
Chicken pot __	crosswordheaven.com/clues/chicken-pot-__
"American ___"	crosswordheaven.com/clues/american-___
Little Jack Horner's dessert	crosswordheaven.com/clues/little-jack-horners-dessert
Tin contents	crosswordheaven.com/clues/tin-contents
Kind of filling	crosswordheaven.com/clues/kind-of-filling
Three Stooges missile	crosswordheaven.com/clues/three-stooges-missile
Trivial Pursuit goal	crosswordheaven.com/clues/trivial-pursuit-goal
Representation of a budget, often	crosswordheaven.com/clues/representation-of-a-budget-often
"American ___" (1999 sex comedy)	crosswordheaven.com/clues/american-___-1999-sex-comedy
Dessert menu item	crosswordheaven.com/clues/dessert-menu-item
Word after honey or humble	crosswordheaven.com/clues/word-after-honey-or-humble
Custard concoction	crosswordheaven.com/clues/custard-concoction
Shoeless cobbler?	crosswordheaven.com/clues/shoeless-cobbler
Word with honey or humble	crosswordheaven.com/clues/word-with-honey-or-humble
Slapstick staple	crosswordheaven.com/clues/slapstick-staple
Four-and-twenty blackbirds' place	crosswordheaven.com/clues/four-and-twenty-blackbirds-place
Mississippi mud, e.g.	crosswordheaven.com/clues/mississippi-mud-eg
Sliced dessert	crosswordheaven.com/clues/sliced-dessert
Humble fare	crosswordheaven.com/clues/humble-fare
Pizza or quiche	crosswordheaven.com/clues/pizza-or-quiche
Symbol of easiness	crosswordheaven.com/clues/symbol-of-easiness
Clown's projectile	crosswordheaven.com/clues/clowns-projectile
Window sill cooler	crosswordheaven.com/clues/window-sill-cooler
The Three Little Kittens' reward	crosswordheaven.com/clues/the-three-little-kittens-reward
Type of chart	crosswordheaven.com/clues/type-of-chart
All-American dessert	crosswordheaven.com/clues/all-american-dessert
Bake sale item	crosswordheaven.com/clues/bake-sale-item
Sales receipt?	crosswordheaven.com/clues/sales-receipt
Edible chart?	crosswordheaven.com/clues/edible-chart
Shoofly, e.g.	crosswordheaven.com/clues/shoofly-eg
Fruity dessert	crosswordheaven.com/clues/fruity-dessert
Pizzeria purchase	crosswordheaven.com/clues/pizzeria-purchase
Word with cream or sugar	crosswordheaven.com/clues/word-with-cream-or-sugar
Pastry choice	crosswordheaven.com/clues/pastry-choice
Sky sight?	crosswordheaven.com/clues/sky-sight
Divisible whole, figuratively	crosswordheaven.com/clues/divisible-whole-figuratively
Three Little Kittens' reward	crosswordheaven.com/clues/three-little-kittens-reward
Peach, cherry, or blueberry	crosswordheaven.com/clues/peach-cherry-or-blueberry
Financial chart metaphor	crosswordheaven.com/clues/financial-chart-metaphor
Crusty treat	crosswordheaven.com/clues/crusty-treat
Thanksgiving dessert	crosswordheaven.com/clues/thanksgiving-dessert
Crusty one	crosswordheaven.com/clues/crusty-one
Item often found cooling on a window sill	crosswordheaven.com/clues/item-often-found-cooling-on-a-window-sill
Humble follower?	crosswordheaven.com/clues/humble-follower
Word after sweetie or Tweety	crosswordheaven.com/clues/word-after-sweetie-or-tweety
___ in the sky (empty wish)	crosswordheaven.com/clues/___-in-the-sky-empty-wish
Dessert choice	crosswordheaven.com/clues/dessert-choice
It often has an upper crust	crosswordheaven.com/clues/it-often-has-an-upper-crust
Tasty wedge	crosswordheaven.com/clues/tasty-wedge
Baked dessert	crosswordheaven.com/clues/baked-dessert
Word after cutie or sweetie	crosswordheaven.com/clues/word-after-cutie-or-sweetie
Bakery purchase	crosswordheaven.com/clues/bakery-purchase
Dessert often served Ã  la mode	crosswordheaven.com/clues/dessert-often-served-la-mode
Cap's counterpart	crosswordheaven.com/clues/caps-counterpart
Patisserie purchase	crosswordheaven.com/clues/patisserie-purchase
Mrs. Smith's offering	crosswordheaven.com/clues/mrs-smiths-offering
Baseball Hall of Famer Traynor	crosswordheaven.com/clues/baseball-hall-of-famer-traynor
Chart form	crosswordheaven.com/clues/chart-form
Slapstick missile	crosswordheaven.com/clues/slapstick-missile
"American ___" (1999 Jason Biggs movie)	crosswordheaven.com/clues/american-___-1999-jason-biggs-movie
Dessert with a crust	crosswordheaven.com/clues/dessert-with-a-crust
It may have a crimped crust	crosswordheaven.com/clues/it-may-have-a-crimped-crust
Pizzeria offering	crosswordheaven.com/clues/pizzeria-offering
Dessert in the sky?	crosswordheaven.com/clues/dessert-in-the-sky
Statistical metaphor	crosswordheaven.com/clues/statistical-metaphor
Symbol of ease	crosswordheaven.com/clues/symbol-of-ease
Bakery buy	crosswordheaven.com/clues/bakery-buy
"National Velvet" horse, with "The"	crosswordheaven.com/clues/national-velvet-horse-with-the
Sales chart metaphor	crosswordheaven.com/clues/sales-chart-metaphor
What Jack Horner was eating	crosswordheaven.com/clues/what-jack-horner-was-eating
Dessert option	crosswordheaven.com/clues/dessert-option
Dessert in a tin	crosswordheaven.com/clues/dessert-in-a-tin
Easy as __	crosswordheaven.com/clues/easy-as-__
Pizzeria staple	crosswordheaven.com/clues/pizzeria-staple
Pot attachment	crosswordheaven.com/clues/pot-attachment
Dessert order	crosswordheaven.com/clues/dessert-order
Bake-off entry	crosswordheaven.com/clues/bake-off-entry
See 69-Down	crosswordheaven.com/clues/see-69-down
Cake alternative	crosswordheaven.com/clues/cake-alternative
Fruit-filled dessert	crosswordheaven.com/clues/fruit-filled-dessert
Flaky dessert	crosswordheaven.com/clues/flaky-dessert
Budget chart	crosswordheaven.com/clues/budget-chart
Graph shape	crosswordheaven.com/clues/graph-shape
Whole pizza	crosswordheaven.com/clues/whole-pizza
Dessert-cart choice	crosswordheaven.com/clues/dessert-cart-choice
Mock apple __	crosswordheaven.com/clues/mock-apple-__
Eight slices, often	crosswordheaven.com/clues/eight-slices-often
Diner order	crosswordheaven.com/clues/diner-order
Mud concoction	crosswordheaven.com/clues/mud-concoction
Quiche shape	crosswordheaven.com/clues/quiche-shape
Enterprise, figuratively	crosswordheaven.com/clues/enterprise-figuratively
See 41 Down	crosswordheaven.com/clues/see-41-down
Place for key limes	crosswordheaven.com/clues/place-for-key-limes
Budget representation	crosswordheaven.com/clues/budget-representation
Lemon meringue, for one	crosswordheaven.com/clues/lemon-meringue-for-one
Key lime or Dutch apple	crosswordheaven.com/clues/key-lime-or-dutch-apple
Dessert selection	crosswordheaven.com/clues/dessert-selection
Diner dessert	crosswordheaven.com/clues/diner-dessert
Round food	crosswordheaven.com/clues/round-food
Rhubarb, for one	crosswordheaven.com/clues/rhubarb-for-one
It may have a filling filling	crosswordheaven.com/clues/it-may-have-a-filling-filling
The horse in "National Velvet" (with "The")	crosswordheaven.com/clues/the-horse-in-national-velvet-with-the
Apple or peach, e.g.	crosswordheaven.com/clues/apple-or-peach-eg
Bakery order	crosswordheaven.com/clues/bakery-order
It can be eaten a la mode	crosswordheaven.com/clues/it-can-be-eaten-a-la-mode
Shepherd's, for one	crosswordheaven.com/clues/shepherds-for-one
It's easy	crosswordheaven.com/clues/its-easy
Dessert favorite	crosswordheaven.com/clues/dessert-favorite
Shoofly ___	crosswordheaven.com/clues/shoofly-___
It's just below the upper crust?	crosswordheaven.com/clues/its-just-below-the-upper-crust
Thanksgiving finale	crosswordheaven.com/clues/thanksgiving-finale
It's slapstick material	crosswordheaven.com/clues/its-slapstick-material
Horner's dessert	crosswordheaven.com/clues/horners-dessert
Slapstick projectile	crosswordheaven.com/clues/slapstick-projectile
Reward for three little kittens	crosswordheaven.com/clues/reward-for-three-little-kittens
Bakery goodie	crosswordheaven.com/clues/bakery-goodie
Word with sweetie or cutie	crosswordheaven.com/clues/word-with-sweetie-or-cutie
Baked dish	crosswordheaven.com/clues/baked-dish
Dainty dish of blackbirds	crosswordheaven.com/clues/dainty-dish-of-blackbirds
Something in a shell	crosswordheaven.com/clues/something-in-a-shell
Lure for Simple Simon	crosswordheaven.com/clues/lure-for-simple-simon
Custard creation	crosswordheaven.com/clues/custard-creation
Apple or banana cream	crosswordheaven.com/clues/apple-or-banana-cream
Circular type of graph	crosswordheaven.com/clues/circular-type-of-graph
Apple or cherry creation	crosswordheaven.com/clues/apple-or-cherry-creation
A clown might get it in the face	crosswordheaven.com/clues/a-clown-might-get-it-in-the-face
Food for Jack Horner	crosswordheaven.com/clues/food-for-jack-horner
Thanksgiving wedge	crosswordheaven.com/clues/thanksgiving-wedge
Round dessert	crosswordheaven.com/clues/round-dessert
Cobbler, for example	crosswordheaven.com/clues/cobbler-for-example
Something easy, supposedly	crosswordheaven.com/clues/something-easy-supposedly
Thanksgiving staple	crosswordheaven.com/clues/thanksgiving-staple
Organizational figure	crosswordheaven.com/clues/organizational-figure
Diner staple	crosswordheaven.com/clues/diner-staple
Shoo-fly ___	crosswordheaven.com/clues/shoo-fly-___
Easy dessert?	crosswordheaven.com/clues/easy-dessert
Pizzeria product	crosswordheaven.com/clues/pizzeria-product
Endearment ender, often	crosswordheaven.com/clues/endearment-ender-often
Tin filler	crosswordheaven.com/clues/tin-filler
Mock apple ___	crosswordheaven.com/clues/mock-apple-___
Pecan or apple	crosswordheaven.com/clues/pecan-or-apple
Graphic symbol	crosswordheaven.com/clues/graphic-symbol
Hurled prop that might be made with shaving cream	crosswordheaven.com/clues/hurled-prop-that-might-be-made-with-shaving-cream
Domino's order	crosswordheaven.com/clues/dominos-order
Sweet treat	crosswordheaven.com/clues/sweet-treat
The horse in "National Velvet"	crosswordheaven.com/clues/the-horse-in-national-velvet
Lemon meringue, e.g.	crosswordheaven.com/clues/lemon-meringue-eg
Pastry	crosswordheaven.com/clues/pastry
Bakery offering	crosswordheaven.com/clues/bakery-offering
Crusty dish	crosswordheaven.com/clues/crusty-dish
Key lime, e.g.	crosswordheaven.com/clues/key-lime-eg
Jack Horner's treat	crosswordheaven.com/clues/jack-horners-treat
Eskimo ___	crosswordheaven.com/clues/eskimo-___
Trivial Pursuit symbol	crosswordheaven.com/clues/trivial-pursuit-symbol
Dessert that ties into the puzzle's theme	crosswordheaven.com/clues/dessert-that-ties-into-the-puzzles-theme
Something simple, supposedly	crosswordheaven.com/clues/something-simple-supposedly
Home to four-and-twenty blackbirds	crosswordheaven.com/clues/home-to-four-and-twenty-blackbirds
Cobbler s cousin	crosswordheaven.com/clues/cobbler-s-cousin
Last word of the theme song to "The Jeffersons"	crosswordheaven.com/clues/last-word-of-the-theme-song-to-the-jeffersons
Circular type of chart	crosswordheaven.com/clues/circular-type-of-chart
Homey dessert	crosswordheaven.com/clues/homey-dessert
Homey dessert	crosswordheaven.com/clues/homey-dessert
Chart format	crosswordheaven.com/clues/chart-format
Slapstick weapon	crosswordheaven.com/clues/slapstick-weapon
Diner treat	crosswordheaven.com/clues/diner-treat
Cobbler's cousin	crosswordheaven.com/clues/cobblers-cousin
Pizzeria buy	crosswordheaven.com/clues/pizzeria-buy
Treat for the Three Little Kittens	crosswordheaven.com/clues/treat-for-the-three-little-kittens
Chart style	crosswordheaven.com/clues/chart-style
Dessert	crosswordheaven.com/clues/dessert
Often fruity dessert	crosswordheaven.com/clues/often-fruity-dessert
Popular dessert	crosswordheaven.com/clues/popular-dessert
Cobbler kin	crosswordheaven.com/clues/cobbler-kin
Flaky treat	crosswordheaven.com/clues/flaky-treat
Pizza, e.g.	crosswordheaven.com/clues/pizza-eg
Bakery item	crosswordheaven.com/clues/bakery-item
Patisserie product	crosswordheaven.com/clues/patisserie-product
Prop for a clown	crosswordheaven.com/clues/prop-for-a-clown
Banana cream, for one	crosswordheaven.com/clues/banana-cream-for-one
Chart inspiration	crosswordheaven.com/clues/chart-inspiration
Chart choice	crosswordheaven.com/clues/chart-choice
Boston cream or Key lime	crosswordheaven.com/clues/boston-cream-or-key-lime
Boston cream ___	crosswordheaven.com/clues/boston-cream-___
Little Italy order	crosswordheaven.com/clues/little-italy-order
Mitten-finding kittens' reward	crosswordheaven.com/clues/mitten-finding-kittens-reward
Pizzeria creation	crosswordheaven.com/clues/pizzeria-creation
Chart template	crosswordheaven.com/clues/chart-template
Cherry or pizza creation	crosswordheaven.com/clues/cherry-or-pizza-creation
You might throw it in someone's face	crosswordheaven.com/clues/you-might-throw-it-in-someones-face
A kind of chart	crosswordheaven.com/clues/a-kind-of-chart
Apple or banana cream dessert	crosswordheaven.com/clues/apple-or-banana-cream-dessert
Saskatoon berry treat	crosswordheaven.com/clues/saskatoon-berry-treat
It's often a la mode	crosswordheaven.com/clues/its-often-a-la-mode
Chart genre	crosswordheaven.com/clues/chart-genre
Pumpkin pastry	crosswordheaven.com/clues/pumpkin-pastry
Quiche, essentially	crosswordheaven.com/clues/quiche-essentially
Pecan, e.g.	crosswordheaven.com/clues/pecan-eg
Ã€ la mode serving	crosswordheaven.com/clues/a-la-mode-serving
Chart model	crosswordheaven.com/clues/chart-model
With 19-Across, item for many cobblers	crosswordheaven.com/clues/with-19-across-item-for-many-cobblers
Dessert served in triangular slices	crosswordheaven.com/clues/dessert-served-in-triangular-slices
Chart or plate preceder	crosswordheaven.com/clues/chart-or-plate-preceder
Buster Keaton missile	crosswordheaven.com/clues/buster-keaton-missile
Lemon meringue ___	crosswordheaven.com/clues/lemon-meringue-___
Place for 24 blackbirds, in verse	crosswordheaven.com/clues/place-for-24-blackbirds-in-verse
Amount to be divvied up	crosswordheaven.com/clues/amount-to-be-divvied-up
Budget chart shape	crosswordheaven.com/clues/budget-chart-shape
___ Ã  la mode	crosswordheaven.com/clues/___-a-la-mode
Holiday dessert	crosswordheaven.com/clues/holiday-dessert
It may have a filling	crosswordheaven.com/clues/it-may-have-a-filling
Chart format	http://www.crosswordgiant.com/crossword-clue/231849/Chart-format
Diner dessert	http://www.crosswordgiant.com/crossword-clue/218641/Diner-dessert
Chart shape	http://www.crosswordgiant.com/crossword-clue/246273/Chart-shape
Slapstick missile	http://www.crosswordgiant.com/crossword-clue/290675/Slapstick-missile
Chart type	http://www.crosswordgiant.com/crossword-clue/225696/Chart-type
Slapstick weapon	http://www.crosswordgiant.com/crossword-clue/206626/Slapstick-weapon
Dessert choice	http://www.crosswordgiant.com/crossword-clue/70672/Dessert-choice
Slapstick prop	http://www.crosswordgiant.com/crossword-clue/195975/Slapstick-prop
Pastry crust with filling	http://www.crosswordgiant.com/crossword-clue/980955/Pastry-crust-with-filling
Pizza order	http://www.crosswordgiant.com/crossword-clue/22212/Pizza-order
Bakery buy	http://www.crosswordgiant.com/crossword-clue/166537/Bakery-buy
Cobbler's cousin	http://www.crosswordgiant.com/crossword-clue/236782/Cobblers-cousin
All-American dessert	http://www.crosswordgiant.com/crossword-clue/494619/All-American-dessert
Baked pastry dish	http://www.crosswordgiant.com/crossword-clue/1003911/Baked-pastry-dish
Pizzeria order	http://www.crosswordgiant.com/crossword-clue/3138/Pizzeria-order
Amount to be divided	http://www.crosswordgiant.com/crossword-clue/22731/Amount-to-be-divided
Epitome of easiness	http://www.crosswordgiant.com/crossword-clue/68807/Epitome-of-easiness
Symbol of easiness	http://www.crosswordgiant.com/crossword-clue/239289/Symbol-of-easiness
Diner treat	http://www.crosswordgiant.com/crossword-clue/696074/Diner-treat
Crusty dessert	http://www.crosswordgiant.com/crossword-clue/165817/Crusty-dessert
Crusty dessert	http://www.crosswordgiant.com/crossword-clue/165817/Crusty-dessert
Boston cream or Key lime	http://www.crosswordgiant.com/crossword-clue/1245337/Boston-cream-or-Key-lime
Sales pitch?	http://www.crosswordgiant.com/crossword-clue/24740/Sales-pitch
Quiche, e.g.	http://www.crosswordgiant.com/crossword-clue/49333/Quiche-e.g
Bakery offering	http://www.crosswordgiant.com/crossword-clue/54078/Bakery-offering
Rhubarb, for one	http://www.crosswordgiant.com/crossword-clue/230999/Rhubarb-for-one
Mississippi mud, e.g.	http://www.crosswordgiant.com/crossword-clue/266451/Mississippi-mud-e.g
Pizzeria buy	http://www.crosswordgiant.com/crossword-clue/287692/Pizzeria-buy
Slapstick projectile	http://www.crosswordgiant.com/crossword-clue/313522/Slapstick-projectile
Diner staple	http://www.crosswordgiant.com/crossword-clue/397232/Diner-staple
Cobbler	http://www.crosswordgiant.com/crossword-clue/34452/Cobbler
Symbol of simplicity	http://www.crosswordgiant.com/crossword-clue/46312/Symbol-of-simplicity
Thanksgiving wedge	http://www.crosswordgiant.com/crossword-clue/150212/Thanksgiving-wedge
It's slapstick material	http://www.crosswordgiant.com/crossword-clue/177936/Its-slapstick-material
Flaky dessert	http://www.crosswordgiant.com/crossword-clue/297266/Flaky-dessert
It may have a filling filling	http://www.crosswordgiant.com/crossword-clue/334465/It-may-have-a-filling-filling
It has some crust	http://www.crosswordgiant.com/crossword-clue/360251/It-has-some-crust
Thanksgiving dessert	http://www.crosswordgiant.com/crossword-clue/364385/Thanksgiving-dessert
Symbol of ease	http://www.crosswordgiant.com/crossword-clue/402944/Symbol-of-ease
Easy as ___	http://www.crosswordgiant.com/crossword-clue/478410/Easy-as-___
Mud concoction	http://www.crosswordgiant.com/crossword-clue/569458/Mud-concoction
Pizzeria creation	http://www.crosswordgiant.com/crossword-clue/613288/Pizzeria-creation
Lemon meringue, for one	http://www.crosswordgiant.com/crossword-clue/760107/Lemon-meringue-for-one
Round dessert	http://www.crosswordgiant.com/crossword-clue/839978/Round-dessert
A clown might get it in the face	http://www.crosswordgiant.com/crossword-clue/850299/A-clown-might-get-it-in-the-face
Baked dish covered with pastry	http://www.crosswordgiant.com/crossword-clue/972812/Baked-dish-covered-with-pastry
Pizza	http://www.crosswordgiant.com/crossword-clue/16303/Pizza
___-eyed	http://www.crosswordgiant.com/crossword-clue/30333/___-eyed
Kind of chart	http://www.crosswordgiant.com/crossword-clue/33528/Kind-of-chart
Cobbler, e.g.	http://www.crosswordgiant.com/crossword-clue/71403/Cobbler-e.g
Mincemeat dessert	http://www.crosswordgiant.com/crossword-clue/102178/Mincemeat-dessert
Exemplar of easiness	http://www.crosswordgiant.com/crossword-clue/112003/Exemplar-of-easiness
Slapstick staple	http://www.crosswordgiant.com/crossword-clue/144461/Slapstick-staple
Fruity dessert	http://www.crosswordgiant.com/crossword-clue/144792/Fruity-dessert
Thanksgiving staple	http://www.crosswordgiant.com/crossword-clue/146996/Thanksgiving-staple
Fruit-filled dessert	http://www.crosswordgiant.com/crossword-clue/151226/Fruit-filled-dessert
Type of chart	http://www.crosswordgiant.com/crossword-clue/160165/Type-of-chart
It's easy	http://www.crosswordgiant.com/crossword-clue/209186/Its-easy
Word with sugar or cream	http://www.crosswordgiant.com/crossword-clue/212860/Word-with-sugar-or-cream
Baked dessert	http://www.crosswordgiant.com/crossword-clue/234014/Baked-dessert
Word with cutie or sweetie	http://www.crosswordgiant.com/crossword-clue/331909/Word-with-cutie-or-sweetie
Comedy staple that goes "splat"	http://www.crosswordgiant.com/crossword-clue/346478/Comedy-staple-that-goes-splat
Thanksgiving finale	http://www.crosswordgiant.com/crossword-clue/372220/Thanksgiving-finale
Budget chart	http://www.crosswordgiant.com/crossword-clue/381216/Budget-chart
Dessert with a crust	http://www.crosswordgiant.com/crossword-clue/388352/Dessert-with-a-crust
Crusty treat	http://www.crosswordgiant.com/crossword-clue/407648/Crusty-treat
Set of wedges?	http://www.crosswordgiant.com/crossword-clue/435156/Set-of-wedges
Dessert favorite	http://www.crosswordgiant.com/crossword-clue/444756/Dessert-favorite
Bake-off entry	http://www.crosswordgiant.com/crossword-clue/463344/Bake-off-entry
Dessert option	http://www.crosswordgiant.com/crossword-clue/482624/Dessert-option
Dessert	http://www.crosswordgiant.com/crossword-clue/518906/Dessert
Bake sale offering	http://www.crosswordgiant.com/crossword-clue/537395/Bake-sale-offering
Pizzeria purchase	http://www.crosswordgiant.com/crossword-clue/543038/Pizzeria-purchase
Kind of filling	http://www.crosswordgiant.com/crossword-clue/655883/Kind-of-filling
Cake alternative	http://www.crosswordgiant.com/crossword-clue/698011/Cake-alternative
Domino's order	http://www.crosswordgiant.com/crossword-clue/890079/Dominos-order
Apple or blueberry	http://www.crosswordgiant.com/crossword-clue/902650/Apple-or-blueberry
In the sky, it's an empty promise	http://www.crosswordgiant.com/crossword-clue/964427/In-the-sky-its-an-empty-promise
Dish baked in pastry-lined pan	http://www.crosswordgiant.com/crossword-clue/970288/Dish-baked-in-pastry-lined-pan
Chart template	http://www.crosswordgiant.com/crossword-clue/1395177/Chart-template
Quiche, essentially	http://www.crosswordgiant.com/crossword-clue/1441240/Quiche-essentially
___ à la mode	http://www.crosswordgiant.com/crossword-clue/1489258/___-la-mode
Christmas ___	http://www.crosswordgiant.com/crossword-clue/572/Christmas-___
Bit of Trivial Pursuit equipment	http://www.crosswordgiant.com/crossword-clue/3516/Bit-of-Trivial-Pursuit-equipment
Something to go to a bakery for	http://www.crosswordgiant.com/crossword-clue/4084/Something-to-go-to-a-bakery-for
Pandowdy, e.g.	http://www.crosswordgiant.com/crossword-clue/8862/Pandowdy-e.g
Soupy Sales missile	http://www.crosswordgiant.com/crossword-clue/11940/Soupy-Sales-missile
Sugar ___	http://www.crosswordgiant.com/crossword-clue/12784/Sugar-___
Popular dessert	http://www.crosswordgiant.com/crossword-clue/15031/Popular-dessert
USA Today chart	http://www.crosswordgiant.com/crossword-clue/24193/USA-Today-chart
It has a shell	http://www.crosswordgiant.com/crossword-clue/25187/It-has-a-shell
Diner order	http://www.crosswordgiant.com/crossword-clue/31735/Diner-order
Trivial Pursuit piece	http://www.crosswordgiant.com/crossword-clue/34645/Trivial-Pursuit-piece
Kind of tin	http://www.crosswordgiant.com/crossword-clue/35760/Kind-of-tin
Item for Little Jack Horner	http://www.crosswordgiant.com/crossword-clue/43134/Item-for-Little-Jack-Horner
Prop in slapstick	http://www.crosswordgiant.com/crossword-clue/44642/Prop-in-slapstick
Patisserie product	http://www.crosswordgiant.com/crossword-clue/50851/Patisserie-product
Thanksgiving serving	http://www.crosswordgiant.com/crossword-clue/65855/Thanksgiving-serving
Crusty one?	http://www.crosswordgiant.com/crossword-clue/67955/Crusty-one
Three Stooges prop	http://www.crosswordgiant.com/crossword-clue/75544/Three-Stooges-prop
Pizzeria output	http://www.crosswordgiant.com/crossword-clue/85125/Pizzeria-output
Comedic missile	http://www.crosswordgiant.com/crossword-clue/129305/Comedic-missile
Order from Domino's	http://www.crosswordgiant.com/crossword-clue/129430/Order-from-Dominos
Ice cream go-with	http://www.crosswordgiant.com/crossword-clue/137875/Ice-cream-go-with
Dessert often served à la mode	http://www.crosswordgiant.com/crossword-clue/148619/Dessert-often-served-la-mode
Sweet treat	http://www.crosswordgiant.com/crossword-clue/149847/Sweet-treat
Graphic symbol	http://www.crosswordgiant.com/crossword-clue/150410/Graphic-symbol
It may be humble	http://www.crosswordgiant.com/crossword-clue/163904/It-may-be-humble
It might be in the sky	http://www.crosswordgiant.com/crossword-clue/169992/It-might-be-in-the-sky
Dessert in a pan	http://www.crosswordgiant.com/crossword-clue/169994/Dessert-in-a-pan
Dainty dish of blackbirds	http://www.crosswordgiant.com/crossword-clue/176377/Dainty-dish-of-blackbirds
After-dinner fare	http://www.crosswordgiant.com/crossword-clue/178986/After-dinner-fare
'American ___'	http://www.crosswordgiant.com/crossword-clue/182379/American-___
'National Velvet' horse	http://www.crosswordgiant.com/crossword-clue/184996/National-Velvet-horse
Word with sweetie or cutie	http://www.crosswordgiant.com/crossword-clue/192645/Word-with-sweetie-or-cutie
Pecan or apple	http://www.crosswordgiant.com/crossword-clue/194015/Pecan-or-apple
Tot's muddy concoction	http://www.crosswordgiant.com/crossword-clue/201308/Tots-muddy-concoction
Tin contents	http://www.crosswordgiant.com/crossword-clue/205695/Tin-contents
Clown's prop	http://www.crosswordgiant.com/crossword-clue/206314/Clowns-prop
Baked dish	http://www.crosswordgiant.com/crossword-clue/207527/Baked-dish
Humble follower	http://www.crosswordgiant.com/crossword-clue/209702/Humble-follower
Epitome of easiness?	http://www.crosswordgiant.com/crossword-clue/220059/Epitome-of-easiness
Mom's dessert	http://www.crosswordgiant.com/crossword-clue/222251/Moms-dessert
Humble dessert?	http://www.crosswordgiant.com/crossword-clue/235487/Humble-dessert
With 13-Down, a diner order	http://www.crosswordgiant.com/crossword-clue/255055/With-13-Down-a-diner-order
Bakery goodie	http://www.crosswordgiant.com/crossword-clue/256310/Bakery-goodie
Type of tin	http://www.crosswordgiant.com/crossword-clue/273750/Type-of-tin
Treat with a crust	http://www.crosswordgiant.com/crossword-clue/281907/Treat-with-a-crust
Key lime or Dutch apple	http://www.crosswordgiant.com/crossword-clue/291357/Key-lime-or-Dutch-apple
Horner's dessert	http://www.crosswordgiant.com/crossword-clue/296235/Horners-dessert
Reward for three little kittens	http://www.crosswordgiant.com/crossword-clue/330851/Reward-for-three-little-kittens
Goodie to be divided	http://www.crosswordgiant.com/crossword-clue/335311/Goodie-to-be-divided
Easy as __	http://www.crosswordgiant.com/crossword-clue/365005/Easy-as-__
Divisible whole, figuratively	http://www.crosswordgiant.com/crossword-clue/370959/Divisible-whole-figuratively
It may be served à la mode	http://www.crosswordgiant.com/crossword-clue/371682/It-may-be-served-la-mode
Crusty dish	http://www.crosswordgiant.com/crossword-clue/382780/Crusty-dish
Easy dessert?	http://www.crosswordgiant.com/crossword-clue/389430/Easy-dessert
Pizzeria staple	http://www.crosswordgiant.com/crossword-clue/390462/Pizzeria-staple
Thanksgiving dessert, often	http://www.crosswordgiant.com/crossword-clue/400187/Thanksgiving-dessert-often
Baked treat	http://www.crosswordgiant.com/crossword-clue/417115/Baked-treat
Pot attachment	http://www.crosswordgiant.com/crossword-clue/418538/Pot-attachment
Pastry	http://www.crosswordgiant.com/crossword-clue/423273/Pastry
Dessert order	http://www.crosswordgiant.com/crossword-clue/428534/Dessert-order
Sliced dessert	http://www.crosswordgiant.com/crossword-clue/431846/Sliced-dessert
Bakery item	http://www.crosswordgiant.com/crossword-clue/434207/Bakery-item
Horner put his thumb in it	http://www.crosswordgiant.com/crossword-clue/434359/Horner-put-his-thumb-in-it
Graph shape	http://www.crosswordgiant.com/crossword-clue/441062/Graph-shape
Apple or cherry e.g.	http://www.crosswordgiant.com/crossword-clue/452175/Apple-or-cherry-e.g
Bakery order	http://www.crosswordgiant.com/crossword-clue/453798/Bakery-order
Prop for a clown	http://www.crosswordgiant.com/crossword-clue/455525/Prop-for-a-clown
Mincemeat ___	http://www.crosswordgiant.com/crossword-clue/461468/Mincemeat-___
USA Today chart shape	http://www.crosswordgiant.com/crossword-clue/462126/USA-Today-chart-shape
What Jack Horner was eating	http://www.crosswordgiant.com/crossword-clue/465967/What-Jack-Horner-was-eating
Holiday dessert	http://www.crosswordgiant.com/crossword-clue/471619/Holiday-dessert
Pizzeria product	http://www.crosswordgiant.com/crossword-clue/473889/Pizzeria-product
Endearment ender, often	http://www.crosswordgiant.com/crossword-clue/481894/Endearment-ender-often
Whole pizza	http://www.crosswordgiant.com/crossword-clue/484355/Whole-pizza
Missile from a prankster	http://www.crosswordgiant.com/crossword-clue/485143/Missile-from-a-prankster
Chart style	http://www.crosswordgiant.com/crossword-clue/486657/Chart-style
Something simple, supposedly	http://www.crosswordgiant.com/crossword-clue/489835/Something-simple-supposedly
Dessert-cart choice	http://www.crosswordgiant.com/crossword-clue/491210/Dessert-cart-choice
Bakery purchase	http://www.crosswordgiant.com/crossword-clue/505289/Bakery-purchase
Velvet's horse	http://www.crosswordgiant.com/crossword-clue/508257/Velvets-horse
It's just below the upper crust?	http://www.crosswordgiant.com/crossword-clue/509541/Its-just-below-the-upper-crust
Shepherd's, for one	http://www.crosswordgiant.com/crossword-clue/511616/Shepherds-for-one
Hurled prop	http://www.crosswordgiant.com/crossword-clue/523346/Hurled-prop
Mock apple __	http://www.crosswordgiant.com/crossword-clue/525743/Mock-apple-__
Eight slices, often	http://www.crosswordgiant.com/crossword-clue/527467/Eight-slices-often
Dish that's a homonym for a number that relates to its shape	http://www.crosswordgiant.com/crossword-clue/545062/Dish-thats-a-homonym-for-a-number-that-relates-to-its-shape
Dessert in a tin	http://www.crosswordgiant.com/crossword-clue/546933/Dessert-in-a-tin
Shepherd's, e.g.	http://www.crosswordgiant.com/crossword-clue/546941/Shepherds-e.g
Tin filler	http://www.crosswordgiant.com/crossword-clue/555420/Tin-filler
Apple or peach, e.g.	http://www.crosswordgiant.com/crossword-clue/572643/Apple-or-peach-e.g
Shoofly ___	http://www.crosswordgiant.com/crossword-clue/581545/Shoofly-___
Dessert in the sky?	http://www.crosswordgiant.com/crossword-clue/583640/Dessert-in-the-sky
Often fruity dessert	http://www.crosswordgiant.com/crossword-clue/585516/Often-fruity-dessert
Statistical metaphor	http://www.crosswordgiant.com/crossword-clue/590363/Statistical-metaphor
Quiche shape	http://www.crosswordgiant.com/crossword-clue/608605/Quiche-shape
Enterprise, figuratively	http://www.crosswordgiant.com/crossword-clue/609408/Enterprise-figuratively
"National Velvet" horse, with "The"	http://www.crosswordgiant.com/crossword-clue/628432/National-Velvet-horse-with-The
See 41 Down	http://www.crosswordgiant.com/crossword-clue/633189/See-41-Down
Trivial Pursuit goal	http://www.crosswordgiant.com/crossword-clue/640611/Trivial-Pursuit-goal
It can be eaten a la mode	http://www.crosswordgiant.com/crossword-clue/652045/It-can-be-eaten-a-la-mode
Cobbler alternative	http://www.crosswordgiant.com/crossword-clue/659908/Cobbler-alternative
Sales chart metaphor	http://www.crosswordgiant.com/crossword-clue/659940/Sales-chart-metaphor
Pizza, e.g.	http://www.crosswordgiant.com/crossword-clue/665599/Pizza-e.g
Little Jack Horner's dessert	http://www.crosswordgiant.com/crossword-clue/668083/Little-Jack-Horners-dessert
Place for key limes	http://www.crosswordgiant.com/crossword-clue/670293/Place-for-key-limes
Shepherd's, for one	http://www.crosswordgiant.com/crossword-clue/676394/Shepherds-for-one
Dessert selection	http://www.crosswordgiant.com/crossword-clue/679978/Dessert-selection
Shoo-fly __	http://www.crosswordgiant.com/crossword-clue/683268/Shoo-fly-__
Representation of a budget, often	http://www.crosswordgiant.com/crossword-clue/686264/Representation-of-a-budget-often
Four-and-twenty blackbirds' place	http://www.crosswordgiant.com/crossword-clue/689948/Four-and-twenty-blackbirds-place
Rhubarb, e.g.	http://www.crosswordgiant.com/crossword-clue/702307/Rhubarb-e.g
It often has an upper crust	http://www.crosswordgiant.com/crossword-clue/712324/It-often-has-an-upper-crust
The horse in "National Velvet" (with "The")	http://www.crosswordgiant.com/crossword-clue/714879/The-horse-in-National-Velvet-with-The
Pizzeria offering	http://www.crosswordgiant.com/crossword-clue/724756/Pizzeria-offering
Pizza parlor order	http://www.crosswordgiant.com/crossword-clue/731639/Pizza-parlor-order
Budget representation	http://www.crosswordgiant.com/crossword-clue/758891/Budget-representation
The three little kittens' reward	http://www.crosswordgiant.com/crossword-clue/760222/The-three-little-kittens-reward
Something in a shell	http://www.crosswordgiant.com/crossword-clue/772766/Something-in-a-shell
Flaky treat	http://www.crosswordgiant.com/crossword-clue/799913/Flaky-treat
Little Jack Horner's dessert	http://www.crosswordgiant.com/crossword-clue/806571/Little-Jack-Horners-dessert
Lure for Simple Simon	http://www.crosswordgiant.com/crossword-clue/813870/Lure-for-Simple-Simon
Three Little Kittens' reward	http://www.crosswordgiant.com/crossword-clue/814744/Three-Little-Kittens-reward
Three Little Kittens' reward	http://www.crosswordgiant.com/crossword-clue/816975/Three-Little-Kittens-reward
Custard creation	http://www.crosswordgiant.com/crossword-clue/820620/Custard-creation
Apple or banana cream	http://www.crosswordgiant.com/crossword-clue/837604/Apple-or-banana-cream
Treat for the Three Little Kittens	http://www.crosswordgiant.com/crossword-clue/839034/Treat-for-the-Three-Little-Kittens
Apple or cherry creation	http://www.crosswordgiant.com/crossword-clue/849695/Apple-or-cherry-creation
Christmas dessert	http://www.crosswordgiant.com/crossword-clue/863354/Christmas-dessert
Cobbler, for example	http://www.crosswordgiant.com/crossword-clue/868662/Cobbler-for-example
Something easy, supposedly	http://www.crosswordgiant.com/crossword-clue/870878/Something-easy-supposedly
Hurled prop that might be made with shaving cream	http://www.crosswordgiant.com/crossword-clue/877422/Hurled-prop-that-might-be-made-with-shaving-cream
Fisherman’s hangout	http://www.crosswordgiant.com/crossword-clue/877986/Fishermans-hangout
Organizational figure	http://www.crosswordgiant.com/crossword-clue/891413/Organizational-figure
The horse in "National Velvet"	http://www.crosswordgiant.com/crossword-clue/905334/The-horse-in-National-Velvet
Cobbler kin	http://www.crosswordgiant.com/crossword-clue/912441/Cobbler-kin
Lemon meringue, e.g.	http://www.crosswordgiant.com/crossword-clue/919357/Lemon-meringue-e.g
Jack Horner's treat	http://www.crosswordgiant.com/crossword-clue/930188/Jack-Horners-treat
A baked dish covered with pastry	http://www.crosswordgiant.com/crossword-clue/955441/A-baked-dish-covered-with-pastry
Eskimo ___	http://www.crosswordgiant.com/crossword-clue/961961/Eskimo-___
In the sky, it's an unrealistic prospect	http://www.crosswordgiant.com/crossword-clue/1006056/In-the-sky-its-an-unrealistic-prospect
In the sky, it's a hopeless idea	http://www.crosswordgiant.com/crossword-clue/1009724/In-the-sky-its-a-hopeless-idea
In the sky, this dish is impractical	http://www.crosswordgiant.com/crossword-clue/1012804/In-the-sky-this-dish-is-impractical
In the sky, this is wishful thinking	http://www.crosswordgiant.com/crossword-clue/1027361/In-the-sky-this-is-wishful-thinking
In hte sky with a hardtop	http://www.crosswordgiant.com/crossword-clue/1072490/In-hte-sky-with-a-hardtop
Shades of how this could get one bald!	http://www.crosswordgiant.com/crossword-clue/1080256/Shades-of-how-this-could-get-one-bald
One for sorrow that's crusty	http://www.crosswordgiant.com/crossword-clue/1094352/One-for-sorrow-thats-crusty
Dozens of birds there for the king	http://www.crosswordgiant.com/crossword-clue/1118790/Dozens-of-birds-there-for-the-king
Although black and white, all black when cooked in this	http://www.crosswordgiant.com/crossword-clue/1134775/Although-black-and-white-all-black-when-cooked-in-this
It's crusty, and there it is in black and white	http://www.crosswordgiant.com/crossword-clue/1141346/Its-crusty-and-there-it-is-in-black-and-white
With a BA, King gets being made so crusty	http://www.crosswordgiant.com/crossword-clue/1147461/With-a-BA-King-gets-being-made-so-crusty
It's maybe in the sky it's baked	http://www.crosswordgiant.com/crossword-clue/1159219/Its-maybe-in-the-sky-its-baked
Given a B, a king might make this	http://www.crosswordgiant.com/crossword-clue/1161970/Given-a-B-a-king-might-make-this
Such ties might be worshipful yet crusty	http://www.crosswordgiant.com/crossword-clue/1170850/Such-ties-might-be-worshipful-yet-crusty
From the oven with crust: in 23 down with hope	http://www.crosswordgiant.com/crossword-clue/1171045/From-the-oven-with-crust-in-23-down-with-hope
Trivial Pursuit symbol	http://www.crosswordgiant.com/crossword-clue/1198729/Trivial-Pursuit-symbol
Dessert that ties into the puzzle's theme	http://www.crosswordgiant.com/crossword-clue/1205020/Dessert-that-ties-into-the-puzzles-theme
Home to four-and-twenty blackbirds	http://www.crosswordgiant.com/crossword-clue/1209041/Home-to-four-and-twenty-blackbirds
Last word of the theme song to 'The Jeffersons'	http://www.crosswordgiant.com/crossword-clue/1228187/Last-word-of-the-theme-song-to-The-Jeffersons
Circular type of chart	http://www.crosswordgiant.com/crossword-clue/1228890/Circular-type-of-chart
Banana cream, for one	http://www.crosswordgiant.com/crossword-clue/1233559/Banana-cream-for-one
Boston cream --	http://www.crosswordgiant.com/crossword-clue/1245281/Boston-cream-
Little Italy order	http://www.crosswordgiant.com/crossword-clue/1245659/Little-Italy-order
Crusty one	http://www.crosswordgiant.com/crossword-clue/1250589/Crusty-one
See 6	http://www.crosswordgiant.com/crossword-clue/1259508/See-6
Pasty - former Indian coin - mixed type - bird	http://www.crosswordgiant.com/crossword-clue/1350256/Pasty-former-Indian-coin-mixed-type-bird
Bird - dish - mixed type	http://www.crosswordgiant.com/crossword-clue/1352286/Bird-dish-mixed-type
Covered tart	http://www.crosswordgiant.com/crossword-clue/1367911/Covered-tart
Pastry dish	http://www.crosswordgiant.com/crossword-clue/1394424/Pastry-dish
Cherry or pizza creation	http://www.crosswordgiant.com/crossword-clue/1406957/Cherry-or-pizza-creation
You might throw it in someone's face	http://www.crosswordgiant.com/crossword-clue/1411795/You-might-throw-it-in-someones-face
A kind of chart	http://www.crosswordgiant.com/crossword-clue/1412723/A-kind-of-chart
Apple or banana cream dessert	http://www.crosswordgiant.com/crossword-clue/1413771/Apple-or-banana-cream-dessert
Saskatoon berry treat	http://www.crosswordgiant.com/crossword-clue/1424189/Saskatoon-berry-treat
It's often a la mode	http://www.crosswordgiant.com/crossword-clue/1425525/Its-often-a-la-mode
Chart genre	http://www.crosswordgiant.com/crossword-clue/1426055/Chart-genre
Home to 24 blackbirds baked in the sky	http://www.crosswordgiant.com/crossword-clue/1433161/Home-to-24-blackbirds-baked-in-the-sky
Pumpkin pastry	http://www.crosswordgiant.com/crossword-clue/1440575/Pumpkin-pastry
Pecan, e.g	http://www.crosswordgiant.com/crossword-clue/1447601/Pecan-e.g
À la mode serving	http://www.crosswordgiant.com/crossword-clue/1450785/-la-mode-serving
Chart model	http://www.crosswordgiant.com/crossword-clue/1455014/Chart-model
With 19-Across, item for many cobblers	http://www.crosswordgiant.com/crossword-clue/1456891/With-19-Across-item-for-many-cobblers
Dessert served in triangular slices	http://www.crosswordgiant.com/crossword-clue/1457791/Dessert-served-in-triangular-slices
Chart or plate preceder	http://www.crosswordgiant.com/crossword-clue/1459709/Chart-or-plate-preceder
Buster Keaton missile	http://www.crosswordgiant.com/crossword-clue/1462368/Buster-Keaton-missile
Dainty dish in 'Sing a Song of Sixpence'	http://www.crosswordgiant.com/crossword-clue/1462723/Dainty-dish-in-Sing-a-Song-of-Sixpence
Lemon meringue --	http://www.crosswordgiant.com/crossword-clue/1467582/Lemon-meringue-
Place for 24 blackbirds, in verse	http://www.crosswordgiant.com/crossword-clue/1468885/Place-for-24-blackbirds-in-verse
Lemon meringue, e.g	http://www.crosswordgiant.com/crossword-clue/1478374/Lemon-meringue-e.g
Budget chart shape	http://www.crosswordgiant.com/crossword-clue/1478613/Budget-chart-shape
Amount to be divvied up	http://www.crosswordgiant.com/crossword-clue/1493053/Amount-to-be-divvied-up
It may have a filling	http://www.crosswordgiant.com/crossword-clue/1497081/It-may-have-a-filling
Shoofly __	http://www.crosswordgiant.com/crossword-clue/1498155/Shoofly-__
The whole, symbolically	http://www.crosswordgiant.com/crossword-clue/1502147/The-whole-symbolically
