Hot spot	crosswordtracker.com/clue/hot-spot/
Spring	crosswordtracker.com/clue/spring/
Whirlpool	crosswordtracker.com/clue/whirlpool/
Place to be pampered	crosswordtracker.com/clue/place-to-be-pampered/
Bath or Baden-Baden	crosswordtracker.com/clue/bath-or-baden-baden/
Health resort	crosswordtracker.com/clue/health-resort/
Retreat	crosswordtracker.com/clue/retreat/
Health concern	crosswordtracker.com/clue/health-concern/
Resort	crosswordtracker.com/clue/resort-56/
Some like it hot	crosswordtracker.com/clue/some-like-it-hot/
Vacation spot	crosswordtracker.com/clue/vacation-spot/
Watering hole	crosswordtracker.com/clue/watering-hole/
Hot tub	crosswordtracker.com/clue/hot-tub/
Place to relax	crosswordtracker.com/clue/place-to-relax/
Place to unwind	crosswordtracker.com/clue/place-to-unwind/
Relaxing resort	crosswordtracker.com/clue/relaxing-resort/
Mineral springs	crosswordtracker.com/clue/mineral-springs/
Vacation destination	crosswordtracker.com/clue/vacation-destination/
Resting place	crosswordtracker.com/clue/resting-place/
Hotel amenity	crosswordtracker.com/clue/hotel-amenity-2/
Getaway spot	crosswordtracker.com/clue/getaway-spot/
Fitness center	crosswordtracker.com/clue/fitness-center/
Aromatherapy venue	crosswordtracker.com/clue/aromatherapy-venue/
Restorative resort	crosswordtracker.com/clue/restorative-resort/
Health club	crosswordtracker.com/clue/health-club/
Sweat spot	crosswordtracker.com/clue/sweat-spot/
Pampering place	crosswordtracker.com/clue/pampering-place/
Evian, e.g.	crosswordtracker.com/clue/evian-eg/
Hydromassage facility	crosswordtracker.com/clue/hydromassage-facility/
Mineral spring	crosswordtracker.com/clue/mineral-spring/
Place for losers?	crosswordtracker.com/clue/place-for-losers/
Healthful resort	crosswordtracker.com/clue/healthful-resort/
Health farm	crosswordtracker.com/clue/health-farm/
Getaway	crosswordtracker.com/clue/getaway/
Massage locale	crosswordtracker.com/clue/massage-locale/
Jacuzzi	crosswordtracker.com/clue/jacuzzi-6/
Kind of treatment	crosswordtracker.com/clue/kind-of-treatment/
Hot springs	crosswordtracker.com/clue/hot-springs-3/
Baden-Baden, e.g.	crosswordtracker.com/clue/baden-baden-eg/
Marienbad, for one	crosswordtracker.com/clue/marienbad-for-one/
Restful resort	crosswordtracker.com/clue/restful-resort/
Seaweed wrap site	crosswordtracker.com/clue/seaweed-wrap-site/
Place for a mud bath	crosswordtracker.com/clue/place-for-a-mud-bath/
Hydrotherapy facility	crosswordtracker.com/clue/hydrotherapy-facility/
Aromatherapy setting	crosswordtracker.com/clue/aromatherapy-setting/
Place for pampering	crosswordtracker.com/clue/place-for-pampering/
Hot spring	crosswordtracker.com/clue/hot-spring/
Ã‰vian, for one	crosswordtracker.com/clue/evian-for-one/
Place for sweaters?	crosswordtracker.com/clue/place-for-sweaters/
Sauna site	crosswordtracker.com/clue/sauna-site/
Masseur's workplace	crosswordtracker.com/clue/masseurs-workplace/
Healthful retreat	crosswordtracker.com/clue/healthful-retreat/
Vacation location	crosswordtracker.com/clue/vacation-location/
Place for a massage	crosswordtracker.com/clue/place-for-a-massage/
Baths	crosswordtracker.com/clue/baths-5/
Spring locale	crosswordtracker.com/clue/spring-locale/
It's good for what ails you	crosswordtracker.com/clue/its-good-for-what-ails-you/
Saratoga Springs, e.g.	crosswordtracker.com/clue/saratoga-springs-eg/
Whirlpool site	crosswordtracker.com/clue/whirlpool-site/
Relaxing retreat	crosswordtracker.com/clue/relaxing-retreat-1/
Masseuse employer	crosswordtracker.com/clue/masseuse-employer/
Spot for a rubdown	crosswordtracker.com/clue/spot-for-a-rubdown/
Curative waters	crosswordtracker.com/clue/curative-waters/
Place for a facial	crosswordtracker.com/clue/place-for-a-facial/
Luxurious resort	crosswordtracker.com/clue/luxurious-resort-1/
Day ___	crosswordtracker.com/clue/day-___-3/
Watering place	crosswordtracker.com/clue/watering-place/
Whirlpool whereabouts	crosswordtracker.com/clue/whirlpool-whereabouts/
Health facility	crosswordtracker.com/clue/health-facility/
Belgian resort	crosswordtracker.com/clue/belgian-resort/
Soaking spot	crosswordtracker.com/clue/soaking-spot/
Toning-up spot	crosswordtracker.com/clue/toning-up-spot/
Curative place	crosswordtracker.com/clue/curative-place/
Bad Ems, e.g.	crosswordtracker.com/clue/bad-ems-eg/
Place for a soak	crosswordtracker.com/clue/place-for-a-soak/
Bathroom installation	crosswordtracker.com/clue/bathroom-installation/
Place to get a massage	crosswordtracker.com/clue/place-to-get-a-massage/
Vacation locale	crosswordtracker.com/clue/vacation-locale/
Masseuse's milieu	crosswordtracker.com/clue/masseuses-milieu/
Baden-Baden is one	crosswordtracker.com/clue/baden-baden-is-one/
Resort hotel	crosswordtracker.com/clue/resort-hotel/
Bath bath	crosswordtracker.com/clue/bath-bath/
Facial spot?	crosswordtracker.com/clue/facial-spot-1/
Relaxing spot	crosswordtracker.com/clue/relaxing-spot/
Curative locale	crosswordtracker.com/clue/curative-locale/
Where to get rubbed the right way?	crosswordtracker.com/clue/where-to-get-rubbed-the-right-way/
Splashy resort	crosswordtracker.com/clue/splashy-resort/
Bad Ems, for one	crosswordtracker.com/clue/bad-ems-for-one/
Mudbath locale	crosswordtracker.com/clue/mudbath-locale/
Healthful getaway	crosswordtracker.com/clue/healthful-getaway-1/
Where fat cats get less fat	crosswordtracker.com/clue/where-fat-cats-get-less-fat/
Relaxing place	crosswordtracker.com/clue/relaxing-place-1/
Mani-pedi place	crosswordtracker.com/clue/mani-pedi-place/
It might make you sweat	crosswordtracker.com/clue/it-might-make-you-sweat/
Hydrotherapy haven	crosswordtracker.com/clue/hydrotherapy-haven/
Belgian resort town	crosswordtracker.com/clue/belgian-resort-town/
Bath, for one	crosswordtracker.com/clue/bath-for-one/
Workout site	crosswordtracker.com/clue/workout-site/
Masseur's milieu	crosswordtracker.com/clue/masseurs-milieu/
Destination for the pampered	crosswordtracker.com/clue/destination-for-the-pampered/
Sweat site	crosswordtracker.com/clue/sweat-site/
Bachelorette party locale	crosswordtracker.com/clue/bachelorette-party-locale/
Springs for a vacation	crosswordtracker.com/clue/springs-for-a-vacation/
Resort feature	crosswordtracker.com/clue/resort-feature/
Resort with hot springs	crosswordtracker.com/clue/resort-with-hot-springs/
Baden-Baden, for one	crosswordtracker.com/clue/baden-baden-for-one/
Its customers may get steamed	crosswordtracker.com/clue/its-customers-may-get-steamed/
Five-star hotel amenity	crosswordtracker.com/clue/five-star-hotel-amenity/
Natural spring	crosswordtracker.com/clue/natural-spring/
New England soda fountain	crosswordtracker.com/clue/new-england-soda-fountain/
Resort for losers?	crosswordtracker.com/clue/resort-for-losers/
Exercise center	crosswordtracker.com/clue/exercise-center/
Site of rejuvenation	crosswordtracker.com/clue/site-of-rejuvenation/
Where one might get steamed	crosswordtracker.com/clue/where-one-might-get-steamed/
Health center	crosswordtracker.com/clue/health-center/
Rest area?	crosswordtracker.com/clue/rest-area-1/
Hydrotherapy venue	crosswordtracker.com/clue/hydrotherapy-venue/
Loser's place?	crosswordtracker.com/clue/losers-place/
Springs for a holiday?	crosswordtracker.com/clue/springs-for-a-holiday/
Place for sweaters	crosswordtracker.com/clue/place-for-sweaters-1/
Chic getaway	crosswordtracker.com/clue/chic-getaway-1/
Place to pamper oneself	crosswordtracker.com/clue/place-to-pamper-oneself/
Place with curative waters	crosswordtracker.com/clue/place-with-curative-waters/
Fat farm	crosswordtracker.com/clue/fat-farm-2/
Hot springs facility	crosswordtracker.com/clue/hot-springs-facility/
Place to refresh oneself	crosswordtracker.com/clue/place-to-refresh-oneself/
Where you might get steamed	crosswordtracker.com/clue/where-you-might-get-steamed/
Massage facility	crosswordtracker.com/clue/massage-facility/
Site of mineral waters	crosswordtracker.com/clue/site-of-mineral-waters/
Upscale hotel amenity	crosswordtracker.com/clue/upscale-hotel-amenity/
Resort of a sort	crosswordtracker.com/clue/resort-of-a-sort/
Where to find sweaters	crosswordtracker.com/clue/where-to-find-sweaters-1/
Where you might get into hot water	crosswordtracker.com/clue/where-you-might-get-into-hot-water-1/
Mud bath venue	crosswordtracker.com/clue/mud-bath-venue/
Balneotherapy venue	crosswordtracker.com/clue/balneotherapy-venue/
Where to get a massage	crosswordtracker.com/clue/where-to-get-a-massage-2/
Place to get a facial	crosswordtracker.com/clue/place-to-get-a-facial/
Masseur employer	crosswordtracker.com/clue/masseur-employer-1/
Aromatherapy locale	crosswordtracker.com/clue/aromatherapy-locale/
Recuperative resort	crosswordtracker.com/clue/recuperative-resort/
Steamy place	crosswordtracker.com/clue/steamy-place/
Mud-bath venue	crosswordtracker.com/clue/mud-bath-venue-1/
Fashionable resort	crosswordtracker.com/clue/fashionable-resort-2/
Workout facility	crosswordtracker.com/clue/workout-facility/
Health haven	crosswordtracker.com/clue/health-haven/
Sort of resort	crosswordtracker.com/clue/sort-of-resort/
Bath, e.g.	crosswordtracker.com/clue/bath-eg/
Menton is one	crosswordtracker.com/clue/menton-is-one/
Vichy, e.g.	crosswordtracker.com/clue/vichy-eg/
Room in the game Clue	crosswordtracker.com/clue/room-in-the-game-clue/
Where you might get a soaking	crosswordtracker.com/clue/where-you-might-get-a-soaking/
Royal Leamington feature	crosswordtracker.com/clue/royal-leamington-feature/
Luxury hotel feature	crosswordtracker.com/clue/luxury-hotel-feature-1/
Pedicure place	crosswordtracker.com/clue/pedicure-place/
Body shop?	crosswordtracker.com/clue/body-shop/
Where losing is intentional	crosswordtracker.com/clue/where-losing-is-intentional/
You can get soaked here	crosswordtracker.com/clue/you-can-get-soaked-here/
Facial spot	crosswordtracker.com/clue/facial-spot/
Where you may get into hot water	crosswordtracker.com/clue/where-you-may-get-into-hot-water/
Place to get a peel	crosswordtracker.com/clue/place-to-get-a-peel/
Jacuzzi setting	crosswordtracker.com/clue/jacuzzi-setting/
Tub with jets	crosswordtracker.com/clue/tub-with-jets/
Mud bath locale	crosswordtracker.com/clue/mud-bath-locale/
Facial place	crosswordtracker.com/clue/facial-place/
Cruise ship amenity	crosswordtracker.com/clue/cruise-ship-amenity/
Place for a body wrap	crosswordtracker.com/clue/place-for-a-body-wrap/
Masseur's employer, perhaps	crosswordtracker.com/clue/masseurs-employer-perhaps/
Resort with mud baths	crosswordtracker.com/clue/resort-with-mud-baths/
Makeover mecca	crosswordtracker.com/clue/makeover-mecca/
Place of therapeutic waters	crosswordtracker.com/clue/place-of-therapeutic-waters/
Hot tub with jets	crosswordtracker.com/clue/hot-tub-with-jets/
Place to get pampered	crosswordtracker.com/clue/place-to-get-pampered/
Place to look at sweaters?	crosswordtracker.com/clue/place-to-look-at-sweaters/
Site for three men in a tub?	crosswordtracker.com/clue/site-for-three-men-in-a-tub/
Resort with a mineral spring	crosswordtracker.com/clue/resort-with-a-mineral-spring/
Joint for health?	crosswordtracker.com/clue/joint-for-health/
Vichy, notably	crosswordtracker.com/clue/vichy-notably/
Treadmill site, perhaps	crosswordtracker.com/clue/treadmill-site-perhaps/
Resort with mineral springs	crosswordtracker.com/clue/resort-with-mineral-springs/
Body treatment venue	crosswordtracker.com/clue/body-treatment-venue/
Where fat cats get thin	crosswordtracker.com/clue/where-fat-cats-get-thin/
Workout center	crosswordtracker.com/clue/workout-center-1/
Spot for a soothing soak	crosswordtracker.com/clue/spot-for-a-soothing-soak/
Jetted bath	crosswordtracker.com/clue/jetted-bath/
Masseur's place	crosswordtracker.com/clue/masseurs-place/
Wet retreat	crosswordtracker.com/clue/wet-retreat/
Massage center	crosswordtracker.com/clue/massage-center/
Rest-cure facility	crosswordtracker.com/clue/rest-cure-facility/
Tub-sharing place	crosswordtracker.com/clue/tub-sharing-place/
New Age music player, often	crosswordtracker.com/clue/new-age-music-player-often/
Whirlpool tub	crosswordtracker.com/clue/whirlpool-tub/
Spring for a vacation?	crosswordtracker.com/clue/spring-for-a-vacation/
Exercise spot	crosswordtracker.com/clue/exercise-spot/
Get into hot water here	crosswordtracker.com/clue/get-into-hot-water-here/
Where it's good to get into hot water?	crosswordtracker.com/clue/where-its-good-to-get-into-hot-water/
Place to get a mud bath	crosswordtracker.com/clue/place-to-get-a-mud-bath/
Hydrotherapy spot	crosswordtracker.com/clue/hydrotherapy-spot/
Where you might get into hot water?	crosswordtracker.com/clue/where-you-might-get-into-hot-water/
Whirlpool locale	crosswordtracker.com/clue/whirlpool-locale/
Elite retreat	crosswordtracker.com/clue/elite-retreat/
Hydrotherapy locale	crosswordtracker.com/clue/hydrotherapy-locale/
Rest spot	crosswordtracker.com/clue/rest-spot/
Hot Springs, e.g.	crosswordtracker.com/clue/hot-springs-eg/
Masseur's workplace, maybe	crosswordtracker.com/clue/masseurs-workplace-maybe/
Bad Ems attraction	crosswordtracker.com/clue/bad-ems-attraction/
Place to chill out	crosswordtracker.com/clue/place-to-chill-out/
Rest cure locale	crosswordtracker.com/clue/rest-cure-locale/
Dieter's destination	crosswordtracker.com/clue/dieters-destination/
Steam bath site	crosswordtracker.com/clue/steam-bath-site-1/
Workout haven	crosswordtracker.com/clue/workout-haven/
Hot tub locale	crosswordtracker.com/clue/hot-tub-locale/
Healthy resort	crosswordtracker.com/clue/healthy-resort-1/
Place for a peel	crosswordtracker.com/clue/place-for-a-peel/
Anagram of "sap"	crosswordtracker.com/clue/anagram-of-sap/
Resort amenity	crosswordtracker.com/clue/resort-amenity/
Place to recuperate	crosswordtracker.com/clue/place-to-recuperate/
Where to sweat it out?	crosswordtracker.com/clue/where-to-sweat-it-out/
Town near LiÃ¨ge	crosswordtracker.com/clue/town-near-liege/
Eponymous Belgian town	crosswordtracker.com/clue/eponymous-belgian-town/
Bathing facility	crosswordtracker.com/clue/bathing-facility/
Jacuzzi site	crosswordtracker.com/clue/jacuzzi-site/
Resort in the Ardennes	crosswordtracker.com/clue/resort-in-the-ardennes/
It has springs	crosswordtracker.com/clue/it-has-springs/
Ballston ___, N.Y.	crosswordtracker.com/clue/ballston-___-ny/
Aix-les-Bains, e.g.	crosswordtracker.com/clue/aix-les-bains-eg/
Salubrious spot	crosswordtracker.com/clue/salubrious-spot/
Baden or Aix	crosswordtracker.com/clue/baden-or-aix/
Nautilus habitat	crosswordtracker.com/clue/nautilus-habitat/
Nautilus locale	crosswordtracker.com/clue/nautilus-locale/
Watering hole?	crosswordtracker.com/clue/watering-hole-8/
"Fat farm"	crosswordtracker.com/clue/fat-farm-4/
Fancy hotel	crosswordtracker.com/clue/fancy-hotel-3/
Place for relaxing	crosswordtracker.com/clue/place-for-relaxing/
Relaxation destination	crosswordtracker.com/clue/relaxation-destination/
Day getaway, perhaps	crosswordtracker.com/clue/day-getaway-perhaps/
Microdermabrasion site	crosswordtracker.com/clue/microdermabrasion-site/
Detoxifying place	crosswordtracker.com/clue/detoxifying-place/
Place for cardio and detox	crosswordtracker.com/clue/place-for-cardio-and-detox/
Evian or Carlsbad	crosswordtracker.com/clue/evian-or-carlsbad/
Gym alternative	crosswordtracker.com/clue/gym-alternative/
Treadmill site	crosswordtracker.com/clue/treadmill-site-1/
Leamington's attraction	crosswordtracker.com/clue/leamingtons-attraction/
Where one might find three men in a tub	crosswordtracker.com/clue/where-one-might-find-three-men-in-a-tub/
Relaxation spot	crosswordtracker.com/clue/relaxation-spot/
A fashionable hotel	crosswordtracker.com/clue/a-fashionable-hotel/
Restorative retreat	crosswordtracker.com/clue/restorative-retreat/
Soda fountain, in New England	crosswordtracker.com/clue/soda-fountain-in-new-england/
Pet protectors' org.	crosswordtracker.com/clue/pet-protectors-org/
Where you may find a sweater	crosswordtracker.com/clue/where-you-may-find-a-sweater/
Bright star in Virgo	crosswordtracker.com/clue/bright-star-in-virgo/
Place for the pampered	crosswordtracker.com/clue/place-for-the-pampered/
Invigorating spot	crosswordtracker.com/clue/invigorating-spot/
Hot bath	crosswordtracker.com/clue/hot-bath/
Hot water locale	crosswordtracker.com/clue/hot-water-locale/
Place with mud masks, often	crosswordtracker.com/clue/place-with-mud-masks-often/
Place with pumice stones	crosswordtracker.com/clue/place-with-pumice-stones/
Place to give yourself pleasure	crosswordtracker.com/clue/place-to-give-yourself-pleasure/
Reflexology place	crosswordtracker.com/clue/reflexology-place/
Place that often sells beauty products	crosswordtracker.com/clue/place-that-often-sells-beauty-products/
Hot stone massage spot	crosswordtracker.com/clue/hot-stone-massage-spot/
One may be situated near hot springs	crosswordtracker.com/clue/one-may-be-situated-near-hot-springs/
Place to get rid of knots	crosswordtracker.com/clue/place-to-get-rid-of-knots/
Massage site	crosswordtracker.com/clue/massage-site/
Brit's hydro, in the States	crosswordtracker.com/clue/brits-hydro-in-the-states/
Rejuvenation place	crosswordtracker.com/clue/rejuvenation-place/
Club with a tub	crosswordtracker.com/clue/club-with-a-tub/
Mudpack site	crosswordtracker.com/clue/mudpack-site/
Backyard bubbler	crosswordtracker.com/clue/backyard-bubbler/
Place for sweating	crosswordtracker.com/clue/place-for-sweating/
Treatment place	crosswordtracker.com/clue/treatment-place/
Cape Cod soda fountain	crosswordtracker.com/clue/cape-cod-soda-fountain/
Mineral spring with an ASP in it?	crosswordtracker.com/clue/mineral-spring-with-an-asp-in-it/
Luxurious getaway	crosswordtracker.com/clue/luxurious-getaway/
Its jets cause turbulence	crosswordtracker.com/clue/its-jets-cause-turbulence/
Massage offerer	crosswordtracker.com/clue/massage-offerer/
Rejuvenation resort	crosswordtracker.com/clue/rejuvenation-resort/
Dieter's resort	crosswordtracker.com/clue/dieters-resort/
Belgian Grand Prix town	crosswordtracker.com/clue/belgian-grand-prix-town/
Springs for a vacation?	crosswordtracker.com/clue/springs-for-a-vacation-1/
Bad Ems or Baden-Baden	crosswordtracker.com/clue/bad-ems-or-baden-baden/
Rejuvenating retreat	crosswordtracker.com/clue/rejuvenating-retreat/
Balneotherapy site	crosswordtracker.com/clue/balneotherapy-site/
Facial center	crosswordtracker.com/clue/facial-center/
Pool with jets	crosswordtracker.com/clue/pool-with-jets/
Curative spot	crosswordtracker.com/clue/curative-spot/
Magazine subtitled "Healthy Living, Travel and Renewal"	crosswordtracker.com/clue/magazine-subtitled-healthy-living-travel-and-renewal/
Where to see algae wraps	crosswordtracker.com/clue/where-to-see-algae-wraps/
Hotel feature, often	crosswordtracker.com/clue/hotel-feature-often/
Resort for relaxation	crosswordtracker.com/clue/resort-for-relaxation/
Joint that's good for the joints	crosswordtracker.com/clue/joint-thats-good-for-the-joints/
Clean getaway?	crosswordtracker.com/clue/clean-getaway/
Spring retreat?	crosswordtracker.com/clue/spring-retreat/
Hot Springs or Bath	crosswordtracker.com/clue/hot-springs-or-bath/
Canyon Ranch offering	crosswordtracker.com/clue/canyon-ranch-offering/
Relaxing vacation destination	crosswordtracker.com/clue/relaxing-vacation-destination/
Therapeutic spot	crosswordtracker.com/clue/therapeutic-spot/
Healthy stop	crosswordtracker.com/clue/healthy-stop/
Healthy place	crosswordtracker.com/clue/healthy-place/
Luxurious vacation spot	crosswordtracker.com/clue/luxurious-vacation-spot/
Losing ground?	crosswordtracker.com/clue/losing-ground/
Place for relaxation	crosswordtracker.com/clue/place-for-relaxation/
Relaxation resort	crosswordtracker.com/clue/relaxation-resort/
De-tension camp?	crosswordtracker.com/clue/de-tension-camp/
Where to go for balneotherapy	crosswordtracker.com/clue/where-to-go-for-balneotherapy/
Sauna setting	crosswordtracker.com/clue/sauna-setting/
Healthful getaway destination	crosswordtracker.com/clue/healthful-getaway-destination/
Resort hidden in the five longest puzzle answers	crosswordtracker.com/clue/resort-hidden-in-the-five-longest-puzzle-answers/
Massage spot	crosswordtracker.com/clue/massage-spot/
Reduction facility	crosswordtracker.com/clue/reduction-facility/
Hot spring, perhaps	crosswordtracker.com/clue/hot-spring-perhaps/
Evian attraction	crosswordtracker.com/clue/evian-attraction/
Baden-Baden or Aix-les-bains, e.g.	crosswordtracker.com/clue/baden-baden-or-aix-les-bains-eg/
Where some losers hang out?	crosswordtracker.com/clue/where-some-losers-hang-out/
Massage palace	crosswordtracker.com/clue/massage-palace/
Perspiration site	crosswordtracker.com/clue/perspiration-site/
Vichy, for one	crosswordtracker.com/clue/vichy-for-one/
Mud wrap spot	crosswordtracker.com/clue/mud-wrap-spot/
Relaxation center	crosswordtracker.com/clue/relaxation-center/
Whirlpool bath	crosswordtracker.com/clue/whirlpool-bath-1/
Invigorating place	crosswordtracker.com/clue/invigorating-place/
Indulgent place	crosswordtracker.com/clue/indulgent-place/
Sweat-and-soak site	crosswordtracker.com/clue/sweat-and-soak-site/
Where to take a mud bath	crosswordtracker.com/clue/where-to-take-a-mud-bath/
Relaxing getaway place	crosswordtracker.com/clue/relaxing-getaway-place/
Health-and-beauty center	crosswordtracker.com/clue/health-and-beauty-center/
Place for a vacation	crosswordtracker.com/clue/place-for-a-vacation/
Steam bath place	crosswordtracker.com/clue/steam-bath-place/
Relaxing site	crosswordtracker.com/clue/relaxing-site/
Place for hydrotherapy	crosswordtracker.com/clue/place-for-hydrotherapy/
Place to get naked, perhaps	crosswordtracker.com/clue/place-to-get-naked-perhaps/
Facility with a jacuzzi	crosswordtracker.com/clue/facility-with-a-jacuzzi/
Jacuzzi, e.g.	crosswordtracker.com/clue/jacuzzi-eg/
Relaxation facility	crosswordtracker.com/clue/relaxation-facility/
Masseuse's workplace	crosswordtracker.com/clue/masseuses-workplace/
Relaxing salon	crosswordtracker.com/clue/relaxing-salon/
Place for a pedicure	crosswordtracker.com/clue/place-for-a-pedicure/
Place to lounge around in a bathrobe	crosswordtracker.com/clue/place-to-lounge-around-in-a-bathrobe/
Spot for a massage	crosswordtracker.com/clue/spot-for-a-massage/
Steamy resort	crosswordtracker.com/clue/steamy-resort/
Where to get a massage and a mudbath	crosswordtracker.com/clue/where-to-get-a-massage-and-a-mudbath/
Upscale hotel offering	crosswordtracker.com/clue/upscale-hotel-offering/
Place for a mudbath	crosswordtracker.com/clue/place-for-a-mudbath/
Place that might feature a sauna	crosswordtracker.com/clue/place-that-might-feature-a-sauna/
Mineral ___	crosswordtracker.com/clue/mineral-___/
Place to get a mudbath or massage	crosswordtracker.com/clue/place-to-get-a-mudbath-or-massage/
Health ___	crosswordtracker.com/clue/health-___/
Place for R&R	crosswordtracker.com/clue/place-for-rr/
Where you may get steamed	crosswordtracker.com/clue/where-you-may-get-steamed/
Rejuvenation location	crosswordtracker.com/clue/rejuvenation-location/
Hot springs site	crosswordtracker.com/clue/hot-springs-site/
Four-star hotel amenity	crosswordtracker.com/clue/four-star-hotel-amenity/
Escape from the rat race	crosswordtracker.com/clue/escape-from-the-rat-race/
Hydrotherapy provider	crosswordtracker.com/clue/hydrotherapy-provider/
Where one might get into hot water	crosswordtracker.com/clue/where-one-might-get-into-hot-water/
Rest cure destination	crosswordtracker.com/clue/rest-cure-destination/
Mud bath spot	crosswordtracker.com/clue/mud-bath-spot/
It might let off some steam	crosswordtracker.com/clue/it-might-let-off-some-steam/
Place for jets	crosswordtracker.com/clue/place-for-jets/
Pool site	crosswordtracker.com/clue/pool-site-1/
Place to find sweaters	crosswordtracker.com/clue/place-to-find-sweaters/
Restorative place	crosswordtracker.com/clue/restorative-place/
Place for a treatment	crosswordtracker.com/clue/place-for-a-treatment/
Hot stone massage place	crosswordtracker.com/clue/hot-stone-massage-place/
Refreshing place	crosswordtracker.com/clue/refreshing-place/
Recuperative spot	crosswordtracker.com/clue/recuperative-spot/
Evian-les-Bains, e.g.	crosswordtracker.com/clue/evian-les-bains-eg/
Place for complimentary bathrobes	crosswordtracker.com/clue/place-for-complimentary-bathrobes/
It might have a splashy opening	crosswordtracker.com/clue/it-might-have-a-splashy-opening/
Masseuse's employer	crosswordtracker.com/clue/masseuses-employer/
Acupuncturist's arena	crosswordtracker.com/clue/acupuncturists-arena/
Health and wellness facility	crosswordtracker.com/clue/health-and-wellness-facility/
Place to get a mudbath	crosswordtracker.com/clue/place-to-get-a-mudbath-1/
Pool hall?	crosswordtracker.com/clue/pool-hall-11/
"Star Wars" and "Battlestar Galactica"	crosswordtracker.com/clue/star-wars-and-battlestar-galactica/
Thalassotherapy site	crosswordtracker.com/clue/thalassotherapy-site/
Day __	crosswordtracker.com/clue/day-__-8/
Place for a rest cure	crosswordtracker.com/clue/place-for-a-rest-cure/
Where folks get into hot water	crosswordtracker.com/clue/where-folks-get-into-hot-water/
Where the robed are rubbed	crosswordtracker.com/clue/where-the-robed-are-rubbed/
Spot for a facial	crosswordtracker.com/clue/spot-for-a-facial/
Luxury resort amenity	crosswordtracker.com/clue/luxury-resort-amenity/
Where a mask may be worn	crosswordtracker.com/clue/where-a-mask-may-be-worn/
Cruise ship facility	crosswordtracker.com/clue/cruise-ship-facility/
Where exfoliation may occur	crosswordtracker.com/clue/where-exfoliation-may-occur/
Resort for reducers	crosswordtracker.com/clue/resort-for-reducers/
Reducing salon	crosswordtracker.com/clue/reducing-salon/
Aromatherapy site	crosswordtracker.com/clue/aromatherapy-site/
Resort with springs	crosswordtracker.com/clue/resort-with-springs/
Where to get a mudbath	crosswordtracker.com/clue/where-to-get-a-mudbath/
Place for a Jacuzzi	crosswordtracker.com/clue/place-for-a-jacuzzi/
Mud treatment setting	crosswordtracker.com/clue/mud-treatment-setting/
Luxury retreat	crosswordtracker.com/clue/luxury-retreat/
Restful retreat	crosswordtracker.com/clue/restful-retreat/
Mud wrap venue	crosswordtracker.com/clue/mud-wrap-venue/
Place to take a cure	crosswordtracker.com/clue/place-to-take-a-cure/
Tub with a whirlpool	crosswordtracker.com/clue/tub-with-a-whirlpool/
Hot resort?	crosswordtracker.com/clue/hot-resort/
Where to do some bodywork?	crosswordtracker.com/clue/where-to-do-some-bodywork/
Spot for three men in a tub?	crosswordtracker.com/clue/spot-for-three-men-in-a-tub/
Pool locale	crosswordtracker.com/clue/pool-locale/
Vichy or Ã‰vian	crosswordtracker.com/clue/vichy-or-evian/
Travel Channel stopover	crosswordtracker.com/clue/travel-channel-stopover/
Place to share a tub	crosswordtracker.com/clue/place-to-share-a-tub/
Place in which to luxuriate	crosswordtracker.com/clue/place-in-which-to-luxuriate/
Baden-Baden or Ã‰vian	crosswordtracker.com/clue/baden-baden-or-evian/
Spring for refreshments	crosswordtracker.com/clue/spring-for-refreshments/
Fancy home amenity	crosswordtracker.com/clue/fancy-home-amenity/
Luxury hotel facility	crosswordtracker.com/clue/luxury-hotel-facility/
Venue of indulgence	crosswordtracker.com/clue/venue-of-indulgence/
Restful place	crosswordtracker.com/clue/restful-place/
Rest and relaxation site	crosswordtracker.com/clue/rest-and-relaxation-site/
Workout hangout	crosswordtracker.com/clue/workout-hangout/
Place for a mani-pedi	crosswordtracker.com/clue/place-for-a-mani-pedi/
Place where you can get into hot water	crosswordtracker.com/clue/place-where-you-can-get-into-hot-water/
Waxing offerer	crosswordtracker.com/clue/waxing-offerer/
Place to sweat	crosswordtracker.com/clue/place-to-sweat/
Hot springs locale	crosswordtracker.com/clue/hot-springs-locale/
Where to get soaked?	crosswordtracker.com/clue/where-to-get-soaked/
Body wrap offerer	crosswordtracker.com/clue/body-wrap-offerer/
Mineral spring site	crosswordtracker.com/clue/mineral-spring-site/
Spot for a peel	crosswordtracker.com/clue/spot-for-a-peel/
England's Harrogate, e.g.	crosswordtracker.com/clue/englands-harrogate-eg/
Place for a little R and R	crosswordtracker.com/clue/place-for-a-little-r-and-r/
Steamboat Springs, Colo., for one	crosswordtracker.com/clue/steamboat-springs-colo-for-one/
Bath or Ã‰vian	crosswordtracker.com/clue/bath-or-evian/
Where some losers hang out	crosswordtracker.com/clue/where-some-losers-hang-out-1/
Trainer's workplace, perhaps	crosswordtracker.com/clue/trainers-workplace-perhaps/
It might afford a remedy	crosswordtracker.com/clue/it-might-afford-a-remedy/
Site of many losses	crosswordtracker.com/clue/site-of-many-losses/
Workout locale	crosswordtracker.com/clue/workout-locale-2/
Bath installation	crosswordtracker.com/clue/bath-installation/
Recovery place	crosswordtracker.com/clue/recovery-place/
Takeoff place?	crosswordtracker.com/clue/takeoff-place-1/
___ City (Saratoga Springs nickname)	crosswordtracker.com/clue/___-city-saratoga-springs-nickname/
Salutary site	crosswordtracker.com/clue/salutary-site/
Ice cream shop, in New England	crosswordtracker.com/clue/ice-cream-shop-in-new-england/
Where one might take off on a vacation?	crosswordtracker.com/clue/where-one-might-take-off-on-a-vacation/
Seaweed-wrap site	crosswordtracker.com/clue/seaweed-wrap-site-1/
Relaxing getaway spot	crosswordtracker.com/clue/relaxing-getaway-spot/
Facial site	crosswordtracker.com/clue/facial-site/
Balneotherapy locale	crosswordtracker.com/clue/balneotherapy-locale/
Lake Manitou, for one	crosswordtracker.com/clue/lake-manitou-for-one/
Health hangout	crosswordtracker.com/clue/health-hangout/
Vichy is one	crosswordtracker.com/clue/vichy-is-one/
Bath is one	crosswordtracker.com/clue/bath-is-one/
Bath, England, e.g.	crosswordtracker.com/clue/bath-england-eg/
Palm Springs, e.g.	crosswordtracker.com/clue/palm-springs-eg/
Ems or Baden-Baden	crosswordtracker.com/clue/ems-or-baden-baden/
Spring that may bring some zing	crosswordtracker.com/clue/spring-that-may-bring-some-zing/
Yankee soda fountain	crosswordtracker.com/clue/yankee-soda-fountain/
Watering spot	crosswordtracker.com/clue/watering-spot-1/
Troon, e.g.	crosswordtracker.com/clue/troon-eg/
Evian or Menton	crosswordtracker.com/clue/evian-or-menton/
Evian is one	crosswordtracker.com/clue/evian-is-one/
Antibes, for one	crosswordtracker.com/clue/antibes-for-one/
Place for fitness buffs	crosswordtracker.com/clue/place-for-fitness-buffs/
Resort SE of LiÃ¨ge	crosswordtracker.com/clue/resort-se-of-liege/
Spring resort	crosswordtracker.com/clue/spring-resort/
Tunbridge Wells is one	crosswordtracker.com/clue/tunbridge-wells-is-one/
Resort near LiÃ¨ge	crosswordtracker.com/clue/resort-near-liege/
Saratoga, e.g.	crosswordtracker.com/clue/saratoga-eg/
Where to warm one's bones	crosswordtracker.com/clue/where-to-warm-ones-bones/
Spot for three men in a tub	crosswordtracker.com/clue/spot-for-three-men-in-a-tub-1/
Wiesbaden, for example	crosswordtracker.com/clue/wiesbaden-for-example/
Tone-up center	crosswordtracker.com/clue/tone-up-center/
Karlovy Vary is one	crosswordtracker.com/clue/karlovy-vary-is-one/
Healing waters	crosswordtracker.com/clue/healing-waters/
Hot-tub locale	crosswordtracker.com/clue/hot-tub-locale-1/
Sauna locale	crosswordtracker.com/clue/sauna-locale/
Dax or Ems	crosswordtracker.com/clue/dax-or-ems/
Bad Soden is one	crosswordtracker.com/clue/bad-soden-is-one/
Fat farm, e.g.	crosswordtracker.com/clue/fat-farm-eg/
Marienbad is one	crosswordtracker.com/clue/marienbad-is-one/
Warm Springs, for one	crosswordtracker.com/clue/warm-springs-for-one/
Resort town of Belgium	crosswordtracker.com/clue/resort-town-of-belgium/
Bad Ems is one	crosswordtracker.com/clue/bad-ems-is-one/
Belgian town	crosswordtracker.com/clue/belgian-town-1/
Eureka Springs, e.g.	crosswordtracker.com/clue/eureka-springs-eg/
Karlsbad is one	crosswordtracker.com/clue/karlsbad-is-one/
French Lick is one	crosswordtracker.com/clue/french-lick-is-one/
Menton or Vichy	crosswordtracker.com/clue/menton-or-vichy/
Spring bringing zing	crosswordtracker.com/clue/spring-bringing-zing/
Where a spring gives zing	crosswordtracker.com/clue/where-a-spring-gives-zing/
Baden twice	crosswordtracker.com/clue/baden-twice/
Where people lose on purpose	crosswordtracker.com/clue/where-people-lose-on-purpose/
Hydrotherapy site	crosswordtracker.com/clue/hydrotherapy-site-1/
Place to find steamers	crosswordtracker.com/clue/place-to-find-steamers/
Place for R and R	crosswordtracker.com/clue/place-for-r-and-r/
LiÃ¨ge province town	crosswordtracker.com/clue/liege-province-town/
Resort with mudbaths	crosswordtracker.com/clue/resort-with-mudbaths/
Locale with a steam bath	crosswordtracker.com/clue/locale-with-a-steam-bath/
Hot spot for jet setters?	crosswordtracker.com/clue/hot-spot-for-jet-setters/
Place to get a frappe	crosswordtracker.com/clue/place-to-get-a-frappe/
Massage therapist hirer	crosswordtracker.com/clue/massage-therapist-hirer-1/
It has jets that cause turbulence	crosswordtracker.com/clue/it-has-jets-that-cause-turbulence/
Treatment center?	crosswordtracker.com/clue/treatment-center-3/
Yoga venue	crosswordtracker.com/clue/yoga-venue/
Day ___ (place to relax)	crosswordtracker.com/clue/day-___-place-to-relax/
Losers' hangout?	crosswordtracker.com/clue/losers-hangout/
Place for steamers?	crosswordtracker.com/clue/place-for-steamers-1/
Rubdown location	crosswordtracker.com/clue/rubdown-location/
Weekend getaway, maybe	crosswordtracker.com/clue/weekend-getaway-maybe/
Detoxification place	crosswordtracker.com/clue/detoxification-place/
Getaway with smaller portions?	crosswordtracker.com/clue/getaway-with-smaller-portions/
Day getaway	crosswordtracker.com/clue/day-getaway/
Where wraps are be made	crosswordtracker.com/clue/where-wraps-are-be-made/
Rubdown site	crosswordtracker.com/clue/rubdown-site/
Weekend retreat	crosswordtracker.com/clue/weekend-retreat/
Recreation spot	crosswordtracker.com/clue/recreation-spot/
Place for rejuvenation	crosswordtracker.com/clue/place-for-rejuvenation/
Christmas home away from home	crosswordtracker.com/clue/christmas-home-away-from-home/
Baden Baden, for one	crosswordtracker.com/clue/baden-baden-for-one-1/
Good place for losing	crosswordtracker.com/clue/good-place-for-losing/
Fat farm feature	crosswordtracker.com/clue/fat-farm-feature-1/
Fitness promoter	crosswordtracker.com/clue/fitness-promoter/
Place to shape up	crosswordtracker.com/clue/place-to-shape-up/
Reducing resort	crosswordtracker.com/clue/reducing-resort-1/
Saratoga Springs lure	crosswordtracker.com/clue/saratoga-springs-lure/
Luxury hotel offering	crosswordtracker.com/clue/luxury-hotel-offering/
Spot for hydrotherapy	crosswordtracker.com/clue/spot-for-hydrotherapy/
Where to find three men in a tub?	crosswordtracker.com/clue/where-to-find-three-men-in-a-tub/
Place to be rejuvenated	crosswordtracker.com/clue/place-to-be-rejuvenated/
ÃƒÂ‰vian, for one	crosswordtracker.com/clue/avian-for-one/
Ritzy watering hole	crosswordtracker.com/clue/ritzy-watering-hole/
Fancy resort	crosswordtracker.com/clue/fancy-resort-1/
Good place to get in hot water	crosswordtracker.com/clue/good-place-to-get-in-hot-water/
This can ease tension	crosswordtracker.com/clue/this-can-ease-tension/
Healthy joint?	crosswordtracker.com/clue/healthy-joint-1/
Curative waters locale	crosswordtracker.com/clue/curative-waters-locale/
Good place to get into hot water	crosswordtracker.com/clue/good-place-to-get-into-hot-water/
Baden-Baden feature	crosswordtracker.com/clue/baden-baden-feature/
Cruise ship feature	crosswordtracker.com/clue/cruise-ship-feature/
It offers losing propositions	crosswordtracker.com/clue/it-offers-losing-propositions/
Marienbad's claim to fame	crosswordtracker.com/clue/marienbads-claim-to-fame/
Hydrotherapy place	crosswordtracker.com/clue/hydrotherapy-place/
Place for losers	crosswordtracker.com/clue/place-for-losers-1/
Relaxing place to spend the day	crosswordtracker.com/clue/relaxing-place-to-spend-the-day/
Place for some losers	crosswordtracker.com/clue/place-for-some-losers/
Mud bath setting	crosswordtracker.com/clue/mud-bath-setting/
Seaweed wrap provider	crosswordtracker.com/clue/seaweed-wrap-provider/
Mud wrap setting	crosswordtracker.com/clue/mud-wrap-setting/
Business that produces sweaters	crosswordtracker.com/clue/business-that-produces-sweaters/
Hydrotherapy setting	crosswordtracker.com/clue/hydrotherapy-setting/
Rest and relaxation facility	crosswordtracker.com/clue/rest-and-relaxation-facility/
Steamy spot for sweaters	crosswordtracker.com/clue/steamy-spot-for-sweaters/
Rejuvenation spot	crosswordtracker.com/clue/rejuvenation-spot/
Where to pamper oneself	crosswordtracker.com/clue/where-to-pamper-oneself/
Place to receive a facial	crosswordtracker.com/clue/place-to-receive-a-facial/
Place with soothing music, perhaps	crosswordtracker.com/clue/place-with-soothing-music-perhaps/
Mani-pedi spot	crosswordtracker.com/clue/mani-pedi-spot/
Where the rub is, sometimes	crosswordtracker.com/clue/where-the-rub-is-sometimes/
Pampering place?	crosswordtracker.com/clue/pampering-place-2/
Health retreat	crosswordtracker.com/clue/health-retreat-1/
Massage therapist's employer	crosswordtracker.com/clue/massage-therapists-employer/
Mudpack offerer	crosswordtracker.com/clue/mudpack-offerer/
Hot tub	http://www.crosswordgiant.com/crossword-clue/239349/Hot-tub
Resort	http://www.crosswordgiant.com/crossword-clue/218975/Resort
Health resort	http://www.crosswordgiant.com/crossword-clue/51082/Health-resort
Masseur's workplace	http://www.crosswordgiant.com/crossword-clue/84732/Masseurs-workplace
Relaxing resort	http://www.crosswordgiant.com/crossword-clue/223787/Relaxing-resort
Masseur's place	http://www.crosswordgiant.com/crossword-clue/243688/Masseurs-place
Restful resort	http://www.crosswordgiant.com/crossword-clue/375079/Restful-resort
Hotel amenity	http://www.crosswordgiant.com/crossword-clue/211818/Hotel-amenity
Place to relax	http://www.crosswordgiant.com/crossword-clue/81324/Place-to-relax
Fitness center	http://www.crosswordgiant.com/crossword-clue/271688/Fitness-center
Place for a mud bath	http://www.crosswordgiant.com/crossword-clue/70625/Place-for-a-mud-bath
Restorative resort	http://www.crosswordgiant.com/crossword-clue/101912/Restorative-resort
Pampering place	http://www.crosswordgiant.com/crossword-clue/33573/Pampering-place
Mineral spring	http://www.crosswordgiant.com/crossword-clue/47046/Mineral-spring
Place to unwind	http://www.crosswordgiant.com/crossword-clue/13138/Place-to-unwind
Place to be pampered	http://www.crosswordgiant.com/crossword-clue/334055/Place-to-be-pampered
Sauna site	http://www.crosswordgiant.com/crossword-clue/110105/Sauna-site
Health farm	http://www.crosswordgiant.com/crossword-clue/127998/Health-farm
Marienbad, for one	http://www.crosswordgiant.com/crossword-clue/22247/Marienbad-for-one
Health facility	http://www.crosswordgiant.com/crossword-clue/40772/Health-facility
Seaweed wrap site	http://www.crosswordgiant.com/crossword-clue/357749/Seaweed-wrap-site
Relaxing retreat	http://www.crosswordgiant.com/crossword-clue/113339/Relaxing-retreat
Relaxing place	http://www.crosswordgiant.com/crossword-clue/228324/Relaxing-place
Aromatherapy setting	http://www.crosswordgiant.com/crossword-clue/337344/Aromatherapy-setting
Health club	http://www.crosswordgiant.com/crossword-clue/15755/Health-club
Masseuse employer	http://www.crosswordgiant.com/crossword-clue/28266/Masseuse-employer
Hydrotherapy facility	http://www.crosswordgiant.com/crossword-clue/264057/Hydrotherapy-facility
Healthful resort	http://www.crosswordgiant.com/crossword-clue/379887/Healthful-resort
Resort at a mineral spring	http://www.crosswordgiant.com/crossword-clue/954406/Resort-at-a-mineral-spring
Massage setting	http://www.crosswordgiant.com/crossword-clue/245543/Massage-setting
Whirlpool site	http://www.crosswordgiant.com/crossword-clue/442464/Whirlpool-site
Relaxing site	http://www.crosswordgiant.com/crossword-clue/462267/Relaxing-site
Hot spring	http://www.crosswordgiant.com/crossword-clue/164139/Hot-spring
Bad Ems, e.g.	http://www.crosswordgiant.com/crossword-clue/18288/Bad-Ems-e.g
Hydromassage facility	http://www.crosswordgiant.com/crossword-clue/53174/Hydromassage-facility
Curative waters	http://www.crosswordgiant.com/crossword-clue/201861/Curative-waters
Place for the pampered	http://www.crosswordgiant.com/crossword-clue/238038/Place-for-the-pampered
Massage locale	http://www.crosswordgiant.com/crossword-clue/260669/Massage-locale
Healthful retreat	http://www.crosswordgiant.com/crossword-clue/268679/Healthful-retreat
Soaking site	http://www.crosswordgiant.com/crossword-clue/348600/Soaking-site
Whirlpool whereabouts	http://www.crosswordgiant.com/crossword-clue/34246/Whirlpool-whereabouts
Whirlpool	http://www.crosswordgiant.com/crossword-clue/39271/Whirlpool
Day ___	http://www.crosswordgiant.com/crossword-clue/56788/Day-___
Masseur's milieu	http://www.crosswordgiant.com/crossword-clue/122188/Masseurs-milieu
Evian, for one	http://www.crosswordgiant.com/crossword-clue/141934/Evian-for-one
Masseuse's milieu	http://www.crosswordgiant.com/crossword-clue/188134/Masseuses-milieu
Curative locale	http://www.crosswordgiant.com/crossword-clue/198025/Curative-locale
Curative place	http://www.crosswordgiant.com/crossword-clue/203259/Curative-place
Hotel feature	http://www.crosswordgiant.com/crossword-clue/238597/Hotel-feature
Body shop?	http://www.crosswordgiant.com/crossword-clue/322036/Body-shop
Mud bath setting	http://www.crosswordgiant.com/crossword-clue/324288/Mud-bath-setting
Relaxing spot	http://www.crosswordgiant.com/crossword-clue/380677/Relaxing-spot
Aromatherapy venue	http://www.crosswordgiant.com/crossword-clue/384405/Aromatherapy-venue
Mud bath site	http://www.crosswordgiant.com/crossword-clue/559613/Mud-bath-site
Place for pampering	http://www.crosswordgiant.com/crossword-clue/705337/Place-for-pampering
Five-star hotel amenity	http://www.crosswordgiant.com/crossword-clue/755971/Five-star-hotel-amenity
Massage facility	http://www.crosswordgiant.com/crossword-clue/832047/Massage-facility
Masseur's workplace, maybe	http://www.crosswordgiant.com/crossword-clue/86441/Masseurs-workplace-maybe
Place to get a massage	http://www.crosswordgiant.com/crossword-clue/154596/Place-to-get-a-massage
Destination for the pampered	http://www.crosswordgiant.com/crossword-clue/189933/Destination-for-the-pampered
Where fat cats get less fat	http://www.crosswordgiant.com/crossword-clue/191582/Where-fat-cats-get-less-fat
Jacuzzi	http://www.crosswordgiant.com/crossword-clue/205970/Jacuzzi
Place for sweaters?	http://www.crosswordgiant.com/crossword-clue/249469/Place-for-sweaters
Royal Leamington feature	http://www.crosswordgiant.com/crossword-clue/283064/Royal-Leamington-feature
Where to get rubbed the right way?	http://www.crosswordgiant.com/crossword-clue/721799/Where-to-get-rubbed-the-right-way
Elite retreat	http://www.crosswordgiant.com/crossword-clue/875664/Elite-retreat
Detoxifying place	http://www.crosswordgiant.com/crossword-clue/896803/Detoxifying-place
Watering place	http://www.crosswordgiant.com/crossword-clue/914842/Watering-place
Vacation spot	http://www.crosswordgiant.com/crossword-clue/1152/Vacation-spot
Watering hole	http://www.crosswordgiant.com/crossword-clue/6993/Watering-hole
Spring	http://www.crosswordgiant.com/crossword-clue/7187/Spring
Fat farm	http://www.crosswordgiant.com/crossword-clue/15685/Fat-farm
Place for sweaters	http://www.crosswordgiant.com/crossword-clue/38954/Place-for-sweaters
Jacuzzi site	http://www.crosswordgiant.com/crossword-clue/40965/Jacuzzi-site
Health haven	http://www.crosswordgiant.com/crossword-clue/53048/Health-haven
Saratoga Springs, e.g.	http://www.crosswordgiant.com/crossword-clue/72352/Saratoga-Springs-e.g
Évian, e.g.	http://www.crosswordgiant.com/crossword-clue/80946/vian-e.g
Luxury hotel feature	http://www.crosswordgiant.com/crossword-clue/82241/Luxury-hotel-feature
Place for a massage	http://www.crosswordgiant.com/crossword-clue/117461/Place-for-a-massage
Luxurious resort	http://www.crosswordgiant.com/crossword-clue/124639/Luxurious-resort
Jacuzzi setting	http://www.crosswordgiant.com/crossword-clue/124978/Jacuzzi-setting
Workout center	http://www.crosswordgiant.com/crossword-clue/136762/Workout-center
Splashy resort	http://www.crosswordgiant.com/crossword-clue/152248/Splashy-resort
Where you might get a soaking	http://www.crosswordgiant.com/crossword-clue/165871/Where-you-might-get-a-soaking
Place for a soak	http://www.crosswordgiant.com/crossword-clue/178845/Place-for-a-soak
Workout site	http://www.crosswordgiant.com/crossword-clue/188015/Workout-site
Mudbath locale	http://www.crosswordgiant.com/crossword-clue/189066/Mudbath-locale
Wet retreat	http://www.crosswordgiant.com/crossword-clue/201859/Wet-retreat
Spot for a rubdown	http://www.crosswordgiant.com/crossword-clue/218448/Spot-for-a-rubdown
Bath site	http://www.crosswordgiant.com/crossword-clue/264048/Bath-site
Getaway spot	http://www.crosswordgiant.com/crossword-clue/279853/Getaway-spot
Mudpack offerer	http://www.crosswordgiant.com/crossword-clue/285005/Mudpack-offerer
Healthful getaway	http://www.crosswordgiant.com/crossword-clue/294764/Healthful-getaway
Site of mineral waters	http://www.crosswordgiant.com/crossword-clue/496533/Site-of-mineral-waters
Natural spring	http://www.crosswordgiant.com/crossword-clue/506692/Natural-spring
Resort with hot springs	http://www.crosswordgiant.com/crossword-clue/557648/Resort-with-hot-springs
Place with curative waters	http://www.crosswordgiant.com/crossword-clue/585670/Place-with-curative-waters
Place to refresh oneself	http://www.crosswordgiant.com/crossword-clue/591589/Place-to-refresh-oneself
Where one might get steamed	http://www.crosswordgiant.com/crossword-clue/635966/Where-one-might-get-steamed
Resort feature	http://www.crosswordgiant.com/crossword-clue/680821/Resort-feature
Hot springs facility	http://www.crosswordgiant.com/crossword-clue/696960/Hot-springs-facility
Its customers may get steamed	http://www.crosswordgiant.com/crossword-clue/750249/Its-customers-may-get-steamed
Upscale hotel amenity	http://www.crosswordgiant.com/crossword-clue/826143/Upscale-hotel-amenity
Relaxing salon	http://www.crosswordgiant.com/crossword-clue/850178/Relaxing-salon
Whirlpool locale	http://www.crosswordgiant.com/crossword-clue/870812/Whirlpool-locale
Mud bath venue	http://www.crosswordgiant.com/crossword-clue/878410/Mud-bath-venue
Where to get a massage	http://www.crosswordgiant.com/crossword-clue/891320/Where-to-get-a-massage
Evian or Carlsbad	http://www.crosswordgiant.com/crossword-clue/922609/Evian-or-Carlsbad
Watering-place	http://www.crosswordgiant.com/crossword-clue/950888/Watering-place
Health resort near a spring	http://www.crosswordgiant.com/crossword-clue/970535/Health-resort-near-a-spring
Mud-bath venue	http://www.crosswordgiant.com/crossword-clue/1208244/Mud-bath-venue
Eponymous Belgian town	http://www.crosswordgiant.com/crossword-clue/1596/Eponymous-Belgian-town
See 62-Across	http://www.crosswordgiant.com/crossword-clue/2792/See-62-Across
Hot spot	http://www.crosswordgiant.com/crossword-clue/3682/Hot-spot
Mineral springs	http://www.crosswordgiant.com/crossword-clue/5271/Mineral-springs
Loser's place?	http://www.crosswordgiant.com/crossword-clue/6593/Losers-place
Health center	http://www.crosswordgiant.com/crossword-clue/13589/Health-center
Trainer's workplace, perhaps	http://www.crosswordgiant.com/crossword-clue/29835/Trainers-workplace-perhaps
Belgian resort town	http://www.crosswordgiant.com/crossword-clue/40060/Belgian-resort-town
Resort in the Ardennes	http://www.crosswordgiant.com/crossword-clue/42400/Resort-in-the-Ardennes
Workout locale	http://www.crosswordgiant.com/crossword-clue/46119/Workout-locale
Takeoff place?	http://www.crosswordgiant.com/crossword-clue/56448/Takeoff-place
It might make you sweat	http://www.crosswordgiant.com/crossword-clue/82754/It-might-make-you-sweat
Baden-Baden, for one	http://www.crosswordgiant.com/crossword-clue/82883/Baden-Baden-for-one
Workout haven	http://www.crosswordgiant.com/crossword-clue/120195/Workout-haven
Spring locale	http://www.crosswordgiant.com/crossword-clue/121612/Spring-locale
Steamy place	http://www.crosswordgiant.com/crossword-clue/133449/Steamy-place
A fashionable hotel	http://www.crosswordgiant.com/crossword-clue/158247/A-fashionable-hotel
Toning-up spot	http://www.crosswordgiant.com/crossword-clue/165242/Toning-up-spot
Resort with mineral springs	http://www.crosswordgiant.com/crossword-clue/181503/Resort-with-mineral-springs
Vacation destination	http://www.crosswordgiant.com/crossword-clue/191171/Vacation-destination
Leamington's attraction	http://www.crosswordgiant.com/crossword-clue/202167/Leamingtons-attraction
Where you might get into hot water	http://www.crosswordgiant.com/crossword-clue/207159/Where-you-might-get-into-hot-water
Vichy, notably	http://www.crosswordgiant.com/crossword-clue/210233/Vichy-notably
Baden-Baden, e.g.	http://www.crosswordgiant.com/crossword-clue/212520/Baden-Baden-e.g
Baths	http://www.crosswordgiant.com/crossword-clue/217120/Baths
Resort for the pampered	http://www.crosswordgiant.com/crossword-clue/218606/Resort-for-the-pampered
Getaway	http://www.crosswordgiant.com/crossword-clue/223807/Getaway
Treadmill site, perhaps	http://www.crosswordgiant.com/crossword-clue/226158/Treadmill-site-perhaps
Belgian resort	http://www.crosswordgiant.com/crossword-clue/232945/Belgian-resort
Joint for health?	http://www.crosswordgiant.com/crossword-clue/236609/Joint-for-health
Restorative retreat	http://www.crosswordgiant.com/crossword-clue/238234/Restorative-retreat
Treadmill site	http://www.crosswordgiant.com/crossword-clue/253533/Treadmill-site
Perspiration site	http://www.crosswordgiant.com/crossword-clue/255994/Perspiration-site
Where you may get into hot water	http://www.crosswordgiant.com/crossword-clue/298695/Where-you-may-get-into-hot-water
Gym alternative	http://www.crosswordgiant.com/crossword-clue/302560/Gym-alternative
Dieter's resort	http://www.crosswordgiant.com/crossword-clue/310312/Dieters-resort
Hydrotherapy venue	http://www.crosswordgiant.com/crossword-clue/312416/Hydrotherapy-venue
Pool site	http://www.crosswordgiant.com/crossword-clue/314917/Pool-site
Place to find sweaters	http://www.crosswordgiant.com/crossword-clue/315795/Place-to-find-sweaters
Spot for hydrotherapy	http://www.crosswordgiant.com/crossword-clue/326019/Spot-for-hydrotherapy
Good place to get into hot water	http://www.crosswordgiant.com/crossword-clue/334834/Good-place-to-get-into-hot-water
Soda fountain, in New England	http://www.crosswordgiant.com/crossword-clue/363633/Soda-fountain-in-New-England
Springs for a vacation	http://www.crosswordgiant.com/crossword-clue/363826/Springs-for-a-vacation
Tub-sharing place	http://www.crosswordgiant.com/crossword-clue/364163/Tub-sharing-place
Facial place	http://www.crosswordgiant.com/crossword-clue/365395/Facial-place
Resort of a sort	http://www.crosswordgiant.com/crossword-clue/367206/Resort-of-a-sort
Masseuse's workplace	http://www.crosswordgiant.com/crossword-clue/379663/Masseuses-workplace
Aromatherapy site	http://www.crosswordgiant.com/crossword-clue/381105/Aromatherapy-site
Facial spot?	http://www.crosswordgiant.com/crossword-clue/397376/Facial-spot
Body treatment venue	http://www.crosswordgiant.com/crossword-clue/399031/Body-treatment-venue
Resort for losers?	http://www.crosswordgiant.com/crossword-clue/400085/Resort-for-losers
Where to find sweaters	http://www.crosswordgiant.com/crossword-clue/412660/Where-to-find-sweaters
Facial spot	http://www.crosswordgiant.com/crossword-clue/464196/Facial-spot
Where you may find a sweater	http://www.crosswordgiant.com/crossword-clue/479212/Where-you-may-find-a-sweater
Place to get a peel	http://www.crosswordgiant.com/crossword-clue/480271/Place-to-get-a-peel
Belgian Grand Prix town	http://www.crosswordgiant.com/crossword-clue/487623/Belgian-Grand-Prix-town
Exercise site	http://www.crosswordgiant.com/crossword-clue/516117/Exercise-site
Steam bath site	http://www.crosswordgiant.com/crossword-clue/517317/Steam-bath-site
Whirlpool bath	http://www.crosswordgiant.com/crossword-clue/555293/Whirlpool-bath
Where you might get into hot water?	http://www.crosswordgiant.com/crossword-clue/561458/Where-you-might-get-into-hot-water
Chic getaway	http://www.crosswordgiant.com/crossword-clue/563998/Chic-getaway
Mud bath locale	http://www.crosswordgiant.com/crossword-clue/566114/Mud-bath-locale
Place to pamper oneself	http://www.crosswordgiant.com/crossword-clue/575772/Place-to-pamper-oneself
Refreshing place	http://www.crosswordgiant.com/crossword-clue/583039/Refreshing-place
Place for a facial	http://www.crosswordgiant.com/crossword-clue/594673/Place-for-a-facial
Place for a body wrap	http://www.crosswordgiant.com/crossword-clue/625061/Place-for-a-body-wrap
Where losing is intentional	http://www.crosswordgiant.com/crossword-clue/639580/Where-losing-is-intentional
You can get soaked here	http://www.crosswordgiant.com/crossword-clue/649176/You-can-get-soaked-here
Relaxation destination	http://www.crosswordgiant.com/crossword-clue/649386/Relaxation-destination
Day getaway, perhaps	http://www.crosswordgiant.com/crossword-clue/662528/Day-getaway-perhaps
Place for a swim	http://www.crosswordgiant.com/crossword-clue/696443/Place-for-a-swim
Jetted bath	http://www.crosswordgiant.com/crossword-clue/710987/Jetted-bath
Indulgent place	http://www.crosswordgiant.com/crossword-clue/721252/Indulgent-place
Bad Ems, for one	http://www.crosswordgiant.com/crossword-clue/723733/Bad-Ems-for-one
Rejuvenation location	http://www.crosswordgiant.com/crossword-clue/728670/Rejuvenation-location
Site of rejuvenation	http://www.crosswordgiant.com/crossword-clue/783147/Site-of-rejuvenation
Sauna locale	http://www.crosswordgiant.com/crossword-clue/786526/Sauna-locale
Bachelorette party locale	http://www.crosswordgiant.com/crossword-clue/801215/Bachelorette-party-locale
Facility with a jacuzzi	http://www.crosswordgiant.com/crossword-clue/807598/Facility-with-a-jacuzzi
Where you might get steamed	http://www.crosswordgiant.com/crossword-clue/814615/Where-you-might-get-steamed
Microdermabrasion site	http://www.crosswordgiant.com/crossword-clue/823988/Microdermabrasion-site
Place to get a mud bath	http://www.crosswordgiant.com/crossword-clue/833068/Place-to-get-a-mud-bath
Hydrotherapy spot	http://www.crosswordgiant.com/crossword-clue/833744/Hydrotherapy-spot
New Age music player, often	http://www.crosswordgiant.com/crossword-clue/840411/New-Age-music-player-often
Whirlpool tub	http://www.crosswordgiant.com/crossword-clue/843868/Whirlpool-tub
Jacuzzi, e.g.	http://www.crosswordgiant.com/crossword-clue/844905/Jacuzzi-e.g
Where the robed are rubbed	http://www.crosswordgiant.com/crossword-clue/868061/Where-the-robed-are-rubbed
Bad Ems attraction	http://www.crosswordgiant.com/crossword-clue/875886/Bad-Ems-attraction
Place to chill out	http://www.crosswordgiant.com/crossword-clue/877332/Place-to-chill-out
Place for a jacuzzi	http://www.crosswordgiant.com/crossword-clue/878403/Place-for-a-jacuzzi
Place to get a facial	http://www.crosswordgiant.com/crossword-clue/890071/Place-to-get-a-facial
It might have a splashy opening	http://www.crosswordgiant.com/crossword-clue/918666/It-might-have-a-splashy-opening
Hot tub locale	http://www.crosswordgiant.com/crossword-clue/924903/Hot-tub-locale
Curative mineral spring	http://www.crosswordgiant.com/crossword-clue/1023069/Curative-mineral-spring
It's in in Europe	http://www.crosswordgiant.com/crossword-clue/1181852/Its-in-in-Europe
With this in it's healthy on the Continent	http://www.crosswordgiant.com/crossword-clue/1185635/With-this-in-its-healthy-on-the-Continent
This is healthy within on the Continent	http://www.crosswordgiant.com/crossword-clue/1190034/This-is-healthy-within-on-the-Continent
Hot tub site	http://www.crosswordgiant.com/crossword-clue/1202933/Hot-tub-site
Place for cardio and detox	http://www.crosswordgiant.com/crossword-clue/1221547/Place-for-cardio-and-detox
Aromatherapy locale	http://www.crosswordgiant.com/crossword-clue/1245693/Aromatherapy-locale
A well-endowed result	http://www.crosswordgiant.com/crossword-clue/1278074/A-well-endowed-result
Health resort at a mineral spring	http://www.crosswordgiant.com/crossword-clue/1461467/Health-resort-at-a-mineral-spring
Weekend retreat	http://www.crosswordgiant.com/crossword-clue/1474907/Weekend-retreat
Pampering place?	http://www.crosswordgiant.com/crossword-clue/1485275/Pampering-place
Detoxifying site	http://www.crosswordgiant.com/crossword-clue/1497666/Detoxifying-site
Place for a little R and R	http://www.crosswordgiant.com/crossword-clue/3483/Place-for-a-little-R-and-R
It's good for what ails you	http://www.crosswordgiant.com/crossword-clue/10724/Its-good-for-what-ails-you
Bathing facility	http://www.crosswordgiant.com/crossword-clue/11979/Bathing-facility
Kind of treatment	http://www.crosswordgiant.com/crossword-clue/12076/Kind-of-treatment
Retreat	http://www.crosswordgiant.com/crossword-clue/15938/Retreat
Hot springs	http://www.crosswordgiant.com/crossword-clue/19349/Hot-springs
Bath or Évian	http://www.crosswordgiant.com/crossword-clue/25598/Bath-or-vian
Where some losers hang out	http://www.crosswordgiant.com/crossword-clue/26620/Where-some-losers-hang-out
It might afford a remedy	http://www.crosswordgiant.com/crossword-clue/32179/It-might-afford-a-remedy
Resting place	http://www.crosswordgiant.com/crossword-clue/33758/Resting-place
Site of many losses	http://www.crosswordgiant.com/crossword-clue/38176/Site-of-many-losses
See 25-Across	http://www.crosswordgiant.com/crossword-clue/39784/See-25-Across
Workout facility	http://www.crosswordgiant.com/crossword-clue/45099/Workout-facility
It has springs	http://www.crosswordgiant.com/crossword-clue/47511/It-has-springs
Bath installation	http://www.crosswordgiant.com/crossword-clue/53737/Bath-installation
Recovery place	http://www.crosswordgiant.com/crossword-clue/55373/Recovery-place
___ City (Saratoga Springs nickname)	http://www.crosswordgiant.com/crossword-clue/58096/___-City-Saratoga-Springs-nickname
Salutary site	http://www.crosswordgiant.com/crossword-clue/58152/Salutary-site
Site for three men in a tub?	http://www.crosswordgiant.com/crossword-clue/58833/Site-for-three-men-in-a-tub
Vacation location	http://www.crosswordgiant.com/crossword-clue/64274/Vacation-location
Ice cream shop, in New England	http://www.crosswordgiant.com/crossword-clue/65127/Ice-cream-shop-in-New-England
Workout spot	http://www.crosswordgiant.com/crossword-clue/66752/Workout-spot
Place to recuperate	http://www.crosswordgiant.com/crossword-clue/69547/Place-to-recuperate
Some like it hot	http://www.crosswordgiant.com/crossword-clue/71627/Some-like-it-hot
Where one might take off on a vacation?	http://www.crosswordgiant.com/crossword-clue/72080/Where-one-might-take-off-on-a-vacation
Sort of resort	http://www.crosswordgiant.com/crossword-clue/102453/Sort-of-resort
Spot for three men in a tub?	http://www.crosswordgiant.com/crossword-clue/102969/Spot-for-three-men-in-a-tub
Relaxation spot	http://www.crosswordgiant.com/crossword-clue/103548/Relaxation-spot
Baden or Aix	http://www.crosswordgiant.com/crossword-clue/117359/Baden-or-Aix
Pool locale	http://www.crosswordgiant.com/crossword-clue/119398/Pool-locale
ƒvian, for one	http://www.crosswordgiant.com/crossword-clue/124391/vian-for-one
Vichy or Évian	http://www.crosswordgiant.com/crossword-clue/126640/Vichy-or-vian
Travel Channel stopover	http://www.crosswordgiant.com/crossword-clue/127207/Travel-Channel-stopover
Town near Liège	http://www.crosswordgiant.com/crossword-clue/134367/Town-near-Lige
Place to share a tub	http://www.crosswordgiant.com/crossword-clue/134752/Place-to-share-a-tub
Place in which to luxuriate	http://www.crosswordgiant.com/crossword-clue/140184/Place-in-which-to-luxuriate
It offers losing propositions	http://www.crosswordgiant.com/crossword-clue/144625/It-offers-losing-propositions
Baden-Baden or Évian	http://www.crosswordgiant.com/crossword-clue/148681/Baden-Baden-or-vian
Ritzy watering hole	http://www.crosswordgiant.com/crossword-clue/150921/Ritzy-watering-hole
Fancy resort	http://www.crosswordgiant.com/crossword-clue/173093/Fancy-resort
Vacation locale	http://www.crosswordgiant.com/crossword-clue/173695/Vacation-locale
Spring for refreshments	http://www.crosswordgiant.com/crossword-clue/178520/Spring-for-refreshments
Marienbad's claim to fame	http://www.crosswordgiant.com/crossword-clue/179144/Marienbads-claim-to-fame
Fancy home amenity	http://www.crosswordgiant.com/crossword-clue/183236/Fancy-home-amenity
Luxury hotel facility	http://www.crosswordgiant.com/crossword-clue/183533/Luxury-hotel-facility
Where to sweat it out?	http://www.crosswordgiant.com/crossword-clue/188949/Where-to-sweat-it-out
Good place to get in hot water	http://www.crosswordgiant.com/crossword-clue/190472/Good-place-to-get-in-hot-water
This can ease tension	http://www.crosswordgiant.com/crossword-clue/194225/This-can-ease-tension
Sweat spot	http://www.crosswordgiant.com/crossword-clue/194966/Sweat-spot
Pet protectors' org.	http://www.crosswordgiant.com/crossword-clue/195457/Pet-protectors-org
Place for relaxing	http://www.crosswordgiant.com/crossword-clue/201261/Place-for-relaxing
Venue of indulgence	http://www.crosswordgiant.com/crossword-clue/202564/Venue-of-indulgence
Restful place	http://www.crosswordgiant.com/crossword-clue/209122/Restful-place
Hot tub haven	http://www.crosswordgiant.com/crossword-clue/210530/Hot-tub-haven
Hydrotherapy place	http://www.crosswordgiant.com/crossword-clue/215574/Hydrotherapy-place
Fat farm feature	http://www.crosswordgiant.com/crossword-clue/225382/Fat-farm-feature
Healthy joint?	http://www.crosswordgiant.com/crossword-clue/228185/Healthy-joint
Place for losers?	http://www.crosswordgiant.com/crossword-clue/230163/Place-for-losers
Treatment center	http://www.crosswordgiant.com/crossword-clue/230859/Treatment-center
Workout venue	http://www.crosswordgiant.com/crossword-clue/233516/Workout-venue
Rest and relaxation site	http://www.crosswordgiant.com/crossword-clue/236805/Rest-and-relaxation-site
Place where you can get into hot water	http://www.crosswordgiant.com/crossword-clue/240666/Place-where-you-can-get-into-hot-water
Waxing offerer	http://www.crosswordgiant.com/crossword-clue/244968/Waxing-offerer
Rest area?	http://www.crosswordgiant.com/crossword-clue/245384/Rest-area
Fitness promoter	http://www.crosswordgiant.com/crossword-clue/249668/Fitness-promoter
Place to shape up	http://www.crosswordgiant.com/crossword-clue/255785/Place-to-shape-up
Place to sweat	http://www.crosswordgiant.com/crossword-clue/258287/Place-to-sweat
Reducing resort	http://www.crosswordgiant.com/crossword-clue/264211/Reducing-resort
Place  for the pampered	http://www.crosswordgiant.com/crossword-clue/265622/Place-for-the-pampered
Soaking spot	http://www.crosswordgiant.com/crossword-clue/269043/Soaking-spot
Place for the  pampered	http://www.crosswordgiant.com/crossword-clue/272863/Place-for-the-pampered
Curative waters locale	http://www.crosswordgiant.com/crossword-clue/274523/Curative-waters-locale
Hot springs locale	http://www.crosswordgiant.com/crossword-clue/275668/Hot-springs-locale
Fashionable resort	http://www.crosswordgiant.com/crossword-clue/275987/Fashionable-resort
Pedicure place	http://www.crosswordgiant.com/crossword-clue/276774/Pedicure-place
Saratoga Springs lure	http://www.crosswordgiant.com/crossword-clue/278491/Saratoga-Springs-lure
Where to get soaked?	http://www.crosswordgiant.com/crossword-clue/280704/Where-to-get-soaked
Facial offerer	http://www.crosswordgiant.com/crossword-clue/292613/Facial-offerer
Where one might find three men in a tub	http://www.crosswordgiant.com/crossword-clue/297455/Where-one-might-find-three-men-in-a-tub
Luxury hotel offering	http://www.crosswordgiant.com/crossword-clue/306446/Luxury-hotel-offering
Resort for soakers	http://www.crosswordgiant.com/crossword-clue/327213/Resort-for-soakers
Place for losers	http://www.crosswordgiant.com/crossword-clue/328997/Place-for-losers
Bathroom installation	http://www.crosswordgiant.com/crossword-clue/333214/Bathroom-installation
Steambath site	http://www.crosswordgiant.com/crossword-clue/336453/Steambath-site
Spring setting	http://www.crosswordgiant.com/crossword-clue/342129/Spring-setting
Day getaway	http://www.crosswordgiant.com/crossword-clue/360958/Day-getaway
Masseur's employer	http://www.crosswordgiant.com/crossword-clue/364806/Masseurs-employer
Where one might get into hot water	http://www.crosswordgiant.com/crossword-clue/372278/Where-one-might-get-into-hot-water
Watery place	http://www.crosswordgiant.com/crossword-clue/375095/Watery-place
Invigorating spot	http://www.crosswordgiant.com/crossword-clue/384614/Invigorating-spot
New England soda fountain	http://www.crosswordgiant.com/crossword-clue/392850/New-England-soda-fountain
Hot spring, perhaps	http://www.crosswordgiant.com/crossword-clue/394190/Hot-spring-perhaps
Cruise ship amenity	http://www.crosswordgiant.com/crossword-clue/396064/Cruise-ship-amenity
Evian attraction	http://www.crosswordgiant.com/crossword-clue/397544/Evian-attraction
Rest cure destination	http://www.crosswordgiant.com/crossword-clue/399560/Rest-cure-destination
Curative spot	http://www.crosswordgiant.com/crossword-clue/399565/Curative-spot
Magazine subtitled "Healthy Living, Travel and Renewal"	http://www.crosswordgiant.com/crossword-clue/409141/Magazine-subtitled-Healthy-Living-Travel-and-Renewal
Facial spot?	http://www.crosswordgiant.com/crossword-clue/412402/Facial-spot
Recuperation site	http://www.crosswordgiant.com/crossword-clue/417496/Recuperation-site
Mud bath spot	http://www.crosswordgiant.com/crossword-clue/417994/Mud-bath-spot
Baden-Baden or Aix-les-bains, e.g.	http://www.crosswordgiant.com/crossword-clue/418183/Baden-Baden-or-Aix-les-bains-e.g
Body shop?	http://www.crosswordgiant.com/crossword-clue/420808/Body-shop
Hot-tub hangout	http://www.crosswordgiant.com/crossword-clue/424656/Hot-tub-hangout
Exercise center	http://www.crosswordgiant.com/crossword-clue/437307/Exercise-center
Relaxing place to spend the day	http://www.crosswordgiant.com/crossword-clue/437530/Relaxing-place-to-spend-the-day
Place for some losers	http://www.crosswordgiant.com/crossword-clue/447171/Place-for-some-losers
Where to see algae wraps	http://www.crosswordgiant.com/crossword-clue/451426/Where-to-see-algae-wraps
Massage venue	http://www.crosswordgiant.com/crossword-clue/455179/Massage-venue
Hot tub locale, perhaps	http://www.crosswordgiant.com/crossword-clue/455193/Hot-tub-locale-perhaps
Where some losers hang out?	http://www.crosswordgiant.com/crossword-clue/479217/Where-some-losers-hang-out
Steam room site	http://www.crosswordgiant.com/crossword-clue/479770/Steam-room-site
Hot Springs or Bath	http://www.crosswordgiant.com/crossword-clue/485807/Hot-Springs-or-Bath
Springs for a vacation?	http://www.crosswordgiant.com/crossword-clue/488597/Springs-for-a-vacation
Resort with a mineral spring	http://www.crosswordgiant.com/crossword-clue/488842/Resort-with-a-mineral-spring
Mudbath site	http://www.crosswordgiant.com/crossword-clue/489891/Mudbath-site
Fat farm, perhaps	http://www.crosswordgiant.com/crossword-clue/497551/Fat-farm-perhaps
Rejuvenation spot	http://www.crosswordgiant.com/crossword-clue/507178/Rejuvenation-spot
Bad Ems or Baden-Baden	http://www.crosswordgiant.com/crossword-clue/508964/Bad-Ems-or-Baden-Baden
Hot bath	http://www.crosswordgiant.com/crossword-clue/509678/Hot-bath
It might let off some steam	http://www.crosswordgiant.com/crossword-clue/512082/It-might-let-off-some-steam
Bath bath	http://www.crosswordgiant.com/crossword-clue/514754/Bath-bath
Where to pamper oneself	http://www.crosswordgiant.com/crossword-clue/515296/Where-to-pamper-oneself
Hot water locale	http://www.crosswordgiant.com/crossword-clue/515794/Hot-water-locale
Rejuvenating retreat	http://www.crosswordgiant.com/crossword-clue/521098/Rejuvenating-retreat
Where wraps are be made	http://www.crosswordgiant.com/crossword-clue/523200/Where-wraps-are-be-made
Exercise venue	http://www.crosswordgiant.com/crossword-clue/525420/Exercise-venue
Bright star in Virgo	http://www.crosswordgiant.com/crossword-clue/525857/Bright-star-in-Virgo
Massage palace	http://www.crosswordgiant.com/crossword-clue/527824/Massage-palace
Place with mud masks, often	http://www.crosswordgiant.com/crossword-clue/539577/Place-with-mud-masks-often
Place for jets	http://www.crosswordgiant.com/crossword-clue/541468/Place-for-jets
Where to see three men in a tub?	http://www.crosswordgiant.com/crossword-clue/543888/Where-to-see-three-men-in-a-tub
Tub with jets	http://www.crosswordgiant.com/crossword-clue/545895/Tub-with-jets
Balneotherapy site	http://www.crosswordgiant.com/crossword-clue/558928/Balneotherapy-site
Where one might find three men in a tub?	http://www.crosswordgiant.com/crossword-clue/559614/Where-one-might-find-three-men-in-a-tub
Jacuzzi joint	http://www.crosswordgiant.com/crossword-clue/560981/Jacuzzi-joint
Hydrotherapy haven	http://www.crosswordgiant.com/crossword-clue/561005/Hydrotherapy-haven
Rubdown site	http://www.crosswordgiant.com/crossword-clue/561697/Rubdown-site
Facial center	http://www.crosswordgiant.com/crossword-clue/562425/Facial-center
Pool with jets	http://www.crosswordgiant.com/crossword-clue/564945/Pool-with-jets
Mud-bath site	http://www.crosswordgiant.com/crossword-clue/576954/Mud-bath-site
Rest spot	http://www.crosswordgiant.com/crossword-clue/584035/Rest-spot
Health maintenance organization?	http://www.crosswordgiant.com/crossword-clue/591087/Health-maintenance-organization
Hot Springs, e.g.	http://www.crosswordgiant.com/crossword-clue/595211/Hot-Springs-e.g
Massage site	http://www.crosswordgiant.com/crossword-clue/600880/Massage-site
Brit's hydro, in the States	http://www.crosswordgiant.com/crossword-clue/604917/Brits-hydro-in-the-States
Refreshing retreat	http://www.crosswordgiant.com/crossword-clue/605453/Refreshing-retreat
Hot Springs attraction	http://www.crosswordgiant.com/crossword-clue/613568/Hot-Springs-attraction
Vichy, for one	http://www.crosswordgiant.com/crossword-clue/625548/Vichy-for-one
Four-star hotel amenity	http://www.crosswordgiant.com/crossword-clue/627032/Four-star-hotel-amenity
Place to receive a facial	http://www.crosswordgiant.com/crossword-clue/628097/Place-to-receive-a-facial
Rejuvenation place	http://www.crosswordgiant.com/crossword-clue/630314/Rejuvenation-place
Masseur's workplace	http://www.crosswordgiant.com/crossword-clue/632098/Masseurs-workplace
Escape from the rat race	http://www.crosswordgiant.com/crossword-clue/639577/Escape-from-the-rat-race
Place to do laps	http://www.crosswordgiant.com/crossword-clue/640728/Place-to-do-laps
Where fat cats get thin	http://www.crosswordgiant.com/crossword-clue/642660/Where-fat-cats-get-thin
Unwinding locale	http://www.crosswordgiant.com/crossword-clue/645408/Unwinding-locale
Club with a tub	http://www.crosswordgiant.com/crossword-clue/649856/Club-with-a-tub
Mudpack site	http://www.crosswordgiant.com/crossword-clue/653860/Mudpack-site
Backyard bubbler	http://www.crosswordgiant.com/crossword-clue/656744/Backyard-bubbler
Ãƒâ€°vian, for one	http://www.crosswordgiant.com/crossword-clue/663138/vian-for-one
Hydrotherapy provider	http://www.crosswordgiant.com/crossword-clue/667985/Hydrotherapy-provider
Place for sweating	http://www.crosswordgiant.com/crossword-clue/667999/Place-for-sweating
Mud wrap spot	http://www.crosswordgiant.com/crossword-clue/672121/Mud-wrap-spot
Treatment place	http://www.crosswordgiant.com/crossword-clue/676323/Treatment-place
Cape Cod soda fountain	http://www.crosswordgiant.com/crossword-clue/678509/Cape-Cod-soda-fountain
Soaking place	http://www.crosswordgiant.com/crossword-clue/679515/Soaking-place
Health ___	http://www.crosswordgiant.com/crossword-clue/680512/Health-___
Mineral spring with an ASP in it?	http://www.crosswordgiant.com/crossword-clue/681699/Mineral-spring-with-an-ASP-in-it
Relaxation center	http://www.crosswordgiant.com/crossword-clue/695922/Relaxation-center
Place for R&R	http://www.crosswordgiant.com/crossword-clue/698394/Place-for-RR
Hydrotherapy locale	http://www.crosswordgiant.com/crossword-clue/699002/Hydrotherapy-locale
Spot for a soothing soak	http://www.crosswordgiant.com/crossword-clue/703418/Spot-for-a-soothing-soak
Where you may get steamed	http://www.crosswordgiant.com/crossword-clue/703430/Where-you-may-get-steamed
Place to get pampered	http://www.crosswordgiant.com/crossword-clue/711723/Place-to-get-pampered
Luxurious getaway	http://www.crosswordgiant.com/crossword-clue/712209/Luxurious-getaway
Place with pumice stones	http://www.crosswordgiant.com/crossword-clue/717721/Place-with-pumice-stones
Invigorating place	http://www.crosswordgiant.com/crossword-clue/719135/Invigorating-place
Its jets cause turbulence	http://www.crosswordgiant.com/crossword-clue/719144/Its-jets-cause-turbulence
Massage offerer	http://www.crosswordgiant.com/crossword-clue/721994/Massage-offerer
Resort hotel	http://www.crosswordgiant.com/crossword-clue/727033/Resort-hotel
Place for a hot tub	http://www.crosswordgiant.com/crossword-clue/727833/Place-for-a-hot-tub
Place to give yourself pleasure	http://www.crosswordgiant.com/crossword-clue/729467/Place-to-give-yourself-pleasure
Exercise spot	http://www.crosswordgiant.com/crossword-clue/729490/Exercise-spot
Sweat-and-soak site	http://www.crosswordgiant.com/crossword-clue/732892/Sweat-and-soak-site
Joint that's good for the joints	http://www.crosswordgiant.com/crossword-clue/733912/Joint-thats-good-for-the-joints
Reflexology place	http://www.crosswordgiant.com/crossword-clue/735294/Reflexology-place
Mudbath offerer	http://www.crosswordgiant.com/crossword-clue/735785/Mudbath-offerer
Place to get a 47-Across	http://www.crosswordgiant.com/crossword-clue/738917/Place-to-get-a-47-Across
Mani-pedi place	http://www.crosswordgiant.com/crossword-clue/739291/Mani-pedi-place
Seaweed wrap provider	http://www.crosswordgiant.com/crossword-clue/741150/Seaweed-wrap-provider
Hot springs site	http://www.crosswordgiant.com/crossword-clue/742329/Hot-springs-site
Mud wrap setting	http://www.crosswordgiant.com/crossword-clue/753018/Mud-wrap-setting
Masseur's place	http://www.crosswordgiant.com/crossword-clue/753937/Masseurs-place
Where to take a mud bath	http://www.crosswordgiant.com/crossword-clue/757217/Where-to-take-a-mud-bath
Rejuvenation resort	http://www.crosswordgiant.com/crossword-clue/762427/Rejuvenation-resort
Clean getaway?	http://www.crosswordgiant.com/crossword-clue/772920/Clean-getaway
Spring retreat?	http://www.crosswordgiant.com/crossword-clue/774845/Spring-retreat
Baden Baden, for one	http://www.crosswordgiant.com/crossword-clue/775442/Baden-Baden-for-one
Upscale hotel offering	http://www.crosswordgiant.com/crossword-clue/775892/Upscale-hotel-offering
Place for a mudbath	http://www.crosswordgiant.com/crossword-clue/779706/Place-for-a-mudbath
Place that might feature a sauna	http://www.crosswordgiant.com/crossword-clue/781643/Place-that-might-feature-a-sauna
Hotel feature, often	http://www.crosswordgiant.com/crossword-clue/782434/Hotel-feature-often
Relaxing getaway place	http://www.crosswordgiant.com/crossword-clue/786532/Relaxing-getaway-place
Resort for relaxation	http://www.crosswordgiant.com/crossword-clue/787663/Resort-for-relaxation
Ãƒâ€°vian, for one	http://www.crosswordgiant.com/crossword-clue/791287/vian-for-one
Health-and-beauty center	http://www.crosswordgiant.com/crossword-clue/800344/Health-and-beauty-center
Place for a vacation	http://www.crosswordgiant.com/crossword-clue/801004/Place-for-a-vacation
Steam bath place	http://www.crosswordgiant.com/crossword-clue/802682/Steam-bath-place
Belgian Grand Prix site	http://www.crosswordgiant.com/crossword-clue/805649/Belgian-Grand-Prix-site
Mineral ___	http://www.crosswordgiant.com/crossword-clue/807393/Mineral-___
Mud-bath setting	http://www.crosswordgiant.com/crossword-clue/819577/Mud-bath-setting
Place for hydrotherapy	http://www.crosswordgiant.com/crossword-clue/819772/Place-for-hydrotherapy
Massage center	http://www.crosswordgiant.com/crossword-clue/822825/Massage-center
Rest-cure facility	http://www.crosswordgiant.com/crossword-clue/824018/Rest-cure-facility
Place to get naked, perhaps	http://www.crosswordgiant.com/crossword-clue/831538/Place-to-get-naked-perhaps
Place that often sells beauty products	http://www.crosswordgiant.com/crossword-clue/834037/Place-that-often-sells-beauty-products
Spring for a vacation?	http://www.crosswordgiant.com/crossword-clue/845902/Spring-for-a-vacation
Relaxation facility	http://www.crosswordgiant.com/crossword-clue/846616/Relaxation-facility
Masseuse's workplace	http://www.crosswordgiant.com/crossword-clue/848326/Masseuses-workplace
Place for a pedicure	http://www.crosswordgiant.com/crossword-clue/850664/Place-for-a-pedicure
Place to lounge around in a bathrobe	http://www.crosswordgiant.com/crossword-clue/852792/Place-to-lounge-around-in-a-bathrobe
Locale for 42-Down	http://www.crosswordgiant.com/crossword-clue/854076/Locale-for-42-Down
Spot for a massage	http://www.crosswordgiant.com/crossword-clue/854769/Spot-for-a-massage
Get into hot water here	http://www.crosswordgiant.com/crossword-clue/856248/Get-into-hot-water-here
Where it's good to get into hot water?	http://www.crosswordgiant.com/crossword-clue/862264/Where-its-good-to-get-into-hot-water
Spring resort	http://www.crosswordgiant.com/crossword-clue/863223/Spring-resort
Steamy resort	http://www.crosswordgiant.com/crossword-clue/866323/Steamy-resort
Where to get a massage and a mudbath	http://www.crosswordgiant.com/crossword-clue/867074/Where-to-get-a-massage-and-a-mudbath
Place to get a mudbath or massage	http://www.crosswordgiant.com/crossword-clue/873060/Place-to-get-a-mudbath-or-massage
Hot stone massage spot	http://www.crosswordgiant.com/crossword-clue/873917/Hot-stone-massage-spot
Place for rejuvenation	http://www.crosswordgiant.com/crossword-clue/876969/Place-for-rejuvenation
Balneotherapy venue	http://www.crosswordgiant.com/crossword-clue/879581/Balneotherapy-venue
Restorative place	http://www.crosswordgiant.com/crossword-clue/883283/Restorative-place
Hot stone massage place	http://www.crosswordgiant.com/crossword-clue/887317/Hot-stone-massage-place
Recuperative spot	http://www.crosswordgiant.com/crossword-clue/892890/Recuperative-spot
Rest cure locale	http://www.crosswordgiant.com/crossword-clue/893124/Rest-cure-locale
One may be situated near hot springs	http://www.crosswordgiant.com/crossword-clue/893147/One-may-be-situated-near-hot-springs
Place with soothing music, perhaps	http://www.crosswordgiant.com/crossword-clue/898458/Place-with-soothing-music-perhaps
Christmas home away from home	http://www.crosswordgiant.com/crossword-clue/901928/Christmas-home-away-from-home
Evian-les-Bains, e.g.	http://www.crosswordgiant.com/crossword-clue/902339/Evian-les-Bains-e.g
Place for complimentary bathrobes	http://www.crosswordgiant.com/crossword-clue/904418/Place-for-complimentary-bathrobes
Business that produces sweaters	http://www.crosswordgiant.com/crossword-clue/910048/Business-that-produces-sweaters
Hydrotherapy setting	http://www.crosswordgiant.com/crossword-clue/911777/Hydrotherapy-setting
Detoxification place	http://www.crosswordgiant.com/crossword-clue/913660/Detoxification-place
Getaway with smaller portions?	http://www.crosswordgiant.com/crossword-clue/916011/Getaway-with-smaller-portions
Hotel's hot spot	http://www.crosswordgiant.com/crossword-clue/917693/Hotels-hot-spot
Where fat cats get thin?	http://www.crosswordgiant.com/crossword-clue/918160/Where-fat-cats-get-thin
Masseuse's employer	http://www.crosswordgiant.com/crossword-clue/919318/Masseuses-employer
Acupuncturist's arena	http://www.crosswordgiant.com/crossword-clue/920284/Acupuncturists-arena
Health and wellness facility	http://www.crosswordgiant.com/crossword-clue/926999/Health-and-wellness-facility
Place to get a mudbath	http://www.crosswordgiant.com/crossword-clue/929734/Place-to-get-a-mudbath
Pool hall?	http://www.crosswordgiant.com/crossword-clue/931299/Pool-hall
'Star Wars' and 'Battlestar Galactica'	http://www.crosswordgiant.com/crossword-clue/932426/Star-Wars-and-Battlestar-Galactica
Thalassotherapy site	http://www.crosswordgiant.com/crossword-clue/933163/Thalassotherapy-site
Watering-place.	http://www.crosswordgiant.com/crossword-clue/952206/Watering-place
A curative mineral spring, or place with one	http://www.crosswordgiant.com/crossword-clue/1000594/A-curative-mineral-spring-or-place-with-one
A curative mineral spring	http://www.crosswordgiant.com/crossword-clue/1012838/A-curative-mineral-spring
A therapeutic hot spring	http://www.crosswordgiant.com/crossword-clue/1029339/A-therapeutic-hot-spring
Resort to getting red at not having been convicted	http://www.crosswordgiant.com/crossword-clue/1048468/Resort-to-getting-red-at-not-having-been-convicted
For the good of your health, get in with it overseas	http://www.crosswordgiant.com/crossword-clue/1055254/For-the-good-of-your-health-get-in-with-it-overseas
How healthy it is to get in on the peninsula	http://www.crosswordgiant.com/crossword-clue/1055325/How-healthy-it-is-to-get-in-on-the-peninsula
For the good of your health, get this in place	http://www.crosswordgiant.com/crossword-clue/1056232/For-the-good-of-your-health-get-this-in-place
For the sake of your health, get overseas in there	http://www.crosswordgiant.com/crossword-clue/1057736/For-the-sake-of-your-health-get-overseas-in-there
For the good of your health, get in and go there	http://www.crosswordgiant.com/crossword-clue/1062797/For-the-good-of-your-health-get-in-and-go-there
It ought to do you good to get in here on the Continent	http://www.crosswordgiant.com/crossword-clue/1066318/It-ought-to-do-you-good-to-get-in-here-on-the-Continent
For your health, go abroad to get in there	http://www.crosswordgiant.com/crossword-clue/1066523/For-your-health-go-abroad-to-get-in-there
For the good of one's health, one might get it in abroad	http://www.crosswordgiant.com/crossword-clue/1066948/For-the-good-of-ones-health-one-might-get-it-in-abroad
For the good of your health, get in on the Continent	http://www.crosswordgiant.com/crossword-clue/1068973/For-the-good-of-your-health-get-in-on-the-Continent
Get in on the Continent	http://www.crosswordgiant.com/crossword-clue/1069307/Get-in-on-the-Continent
For the good of your health, get in there overseas	http://www.crosswordgiant.com/crossword-clue/1071319/For-the-good-of-your-health-get-in-there-overseas
For the good of your health, get in abroad after it	http://www.crosswordgiant.com/crossword-clue/1072097/For-the-good-of-your-health-get-in-abroad-after-it
It's so healthy in the country	http://www.crosswordgiant.com/crossword-clue/1072363/Its-so-healthy-in-the-country
Desw might have a suit for this resort	http://www.crosswordgiant.com/crossword-clue/1075370/Desw-might-have-a-suit-for-this-resort
Here's to your health	http://www.crosswordgiant.com/crossword-clue/1082423/Heres-to-your-health
For the good of your health, get this in abroad	http://www.crosswordgiant.com/crossword-clue/1084881/For-the-good-of-your-health-get-this-in-abroad
For the good of your health in the Peninsula	http://www.crosswordgiant.com/crossword-clue/1087957/For-the-good-of-your-health-in-the-Peninsula
Does one get this in place for the good of one's health	http://www.crosswordgiant.com/crossword-clue/1088948/Does-one-get-this-in-place-for-the-good-of-ones-health
How 15 down might begin to be good for your health	http://www.crosswordgiant.com/crossword-clue/1099049/How-15-down-might-begin-to-be-good-for-your-health
Good for your health in this European country	http://www.crosswordgiant.com/crossword-clue/1103071/Good-for-your-health-in-this-European-country
To get healthy one might get in there in abroad	http://www.crosswordgiant.com/crossword-clue/1107022/To-get-healthy-one-might-get-in-there-in-abroad
For the sake of your health it would get in in Europe	http://www.crosswordgiant.com/crossword-clue/1114939/For-the-sake-of-your-health-it-would-get-in-in-Europe
Up with an afterthought for your good health	http://www.crosswordgiant.com/crossword-clue/1121060/Up-with-an-afterthought-for-your-good-health
Not a poisonous place	http://www.crosswordgiant.com/crossword-clue/1124941/Not-a-poisonous-place
For the good of your health, have a holiday herein	http://www.crosswordgiant.com/crossword-clue/1126085/For-the-good-of-your-health-have-a-holiday-herein
Healthy it would be in the Peninsula	http://www.crosswordgiant.com/crossword-clue/1131370/Healthy-it-would-be-in-the-Peninsula
This for your health gets in in Europe	http://www.crosswordgiant.com/crossword-clue/1132157/This-for-your-health-gets-in-in-Europe
It's healthy in the Peninsula	http://www.crosswordgiant.com/crossword-clue/1136656/Its-healthy-in-the-Peninsula
That's a healthy place in the Peninsula	http://www.crosswordgiant.com/crossword-clue/1138858/Thats-a-healthy-place-in-the-Peninsula
For the sake of your health, gets in abroad	http://www.crosswordgiant.com/crossword-clue/1142007/For-the-sake-of-your-health-gets-in-abroad
How healthy to get an afterthought up here	http://www.crosswordgiant.com/crossword-clue/1144049/How-healthy-to-get-an-afterthought-up-here
What comes at the end up here for your good health	http://www.crosswordgiant.com/crossword-clue/1144840/What-comes-at-the-end-up-here-for-your-good-health
Adds in in Europe	http://www.crosswordgiant.com/crossword-clue/1150924/Adds-in-in-Europe
It's healthy within in Europe	http://www.crosswordgiant.com/crossword-clue/1151511/Its-healthy-within-in-Europe
Therein makes it healthy abroad	http://www.crosswordgiant.com/crossword-clue/1152511/Therein-makes-it-healthy-abroad
It's healthy to be there in a peninsula	http://www.crosswordgiant.com/crossword-clue/1155627/Its-healthy-to-be-there-in-a-peninsula
Des so healthy followed suit	http://www.crosswordgiant.com/crossword-clue/1156281/Des-so-healthy-followed-suit
For your health, it's in on the Continent	http://www.crosswordgiant.com/crossword-clue/1160961/For-your-health-its-in-on-the-Continent
It's for your health that you might get this in on the Continent	http://www.crosswordgiant.com/crossword-clue/1169775/Its-for-your-health-that-you-might-get-this-in-on-the-Continent
It's healthy abroad therein	http://www.crosswordgiant.com/crossword-clue/1170623/Its-healthy-abroad-therein
Day __	http://www.crosswordgiant.com/crossword-clue/1206429/Day-__
Healthy resort	http://www.crosswordgiant.com/crossword-clue/1208240/Healthy-resort
Place for a rest cure	http://www.crosswordgiant.com/crossword-clue/1208640/Place-for-a-rest-cure
R&R site	http://www.crosswordgiant.com/crossword-clue/1216826/RR-site
Where folks get into hot water	http://www.crosswordgiant.com/crossword-clue/1222910/Where-folks-get-into-hot-water
Masseur employer	http://www.crosswordgiant.com/crossword-clue/1224401/Masseur-employer
Place for a peel	http://www.crosswordgiant.com/crossword-clue/1228012/Place-for-a-peel
Spot for a facial	http://www.crosswordgiant.com/crossword-clue/1232216/Spot-for-a-facial
Where a mask may be worn	http://www.crosswordgiant.com/crossword-clue/1242402/Where-a-mask-may-be-worn
Anagram of ''sap''	http://www.crosswordgiant.com/crossword-clue/1243448/Anagram-of-sap
Cruise ship facility	http://www.crosswordgiant.com/crossword-clue/1243957/Cruise-ship-facility
Where exfoliation may occur	http://www.crosswordgiant.com/crossword-clue/1245433/Where-exfoliation-may-occur
Place to get rid of knots	http://www.crosswordgiant.com/crossword-clue/1246025/Place-to-get-rid-of-knots
Resort for reducers	http://www.crosswordgiant.com/crossword-clue/1247143/Resort-for-reducers
Reducing salon	http://www.crosswordgiant.com/crossword-clue/1253669/Reducing-salon
Recreation spot	http://www.crosswordgiant.com/crossword-clue/1256525/Recreation-spot
9 place of Spanish origin	http://www.crosswordgiant.com/crossword-clue/1288234/9-place-of-Spanish-origin
Health resort's endless boom	http://www.crosswordgiant.com/crossword-clue/1315151/Health-resorts-endless-boom
Spring in southern US state	http://www.crosswordgiant.com/crossword-clue/1333137/Spring-in-southern-US-state
Resort with mineral water spring	http://www.crosswordgiant.com/crossword-clue/1360601/Resort-with-mineral-water-spring
Bath - mineral water spring	http://www.crosswordgiant.com/crossword-clue/1376161/Bath-mineral-water-spring
Resort with springs	http://www.crosswordgiant.com/crossword-clue/1403898/Resort-with-springs
Where to get a mudbath	http://www.crosswordgiant.com/crossword-clue/1404056/Where-to-get-a-mudbath
Resort amenity	http://www.crosswordgiant.com/crossword-clue/1416142/Resort-amenity
Luxury retreat	http://www.crosswordgiant.com/crossword-clue/1421193/Luxury-retreat
Mani-pedi spot	http://www.crosswordgiant.com/crossword-clue/1422596/Mani-pedi-spot
Restful retreat	http://www.crosswordgiant.com/crossword-clue/1425120/Restful-retreat
Mud wrap venue	http://www.crosswordgiant.com/crossword-clue/1428180/Mud-wrap-venue
Workout hangout	http://www.crosswordgiant.com/crossword-clue/1428920/Workout-hangout
Where the rub is, sometimes	http://www.crosswordgiant.com/crossword-clue/1430244/Where-the-rub-is-sometimes
Place for a mani-pedi	http://www.crosswordgiant.com/crossword-clue/1430750/Place-for-a-mani-pedi
Body wrap offerer	http://www.crosswordgiant.com/crossword-clue/1434659/Body-wrap-offerer
Mineral spring site	http://www.crosswordgiant.com/crossword-clue/1436811/Mineral-spring-site
Spot for a peel	http://www.crosswordgiant.com/crossword-clue/1438973/Spot-for-a-peel
Steamboat Springs, Colo., for one	http://www.crosswordgiant.com/crossword-clue/1443800/Steamboat-Springs-Colo.-for-one
Seaweed-wrap site	http://www.crosswordgiant.com/crossword-clue/1450403/Seaweed-wrap-site
Relaxing getaway spot	http://www.crosswordgiant.com/crossword-clue/1450971/Relaxing-getaway-spot
Cruise ship feature	http://www.crosswordgiant.com/crossword-clue/1454808/Cruise-ship-feature
Source of water in outer space?	http://www.crosswordgiant.com/crossword-clue/1464010/Source-of-water-in-outer-space
Facial site	http://www.crosswordgiant.com/crossword-clue/1466516/Facial-site
Vacation facility	http://www.crosswordgiant.com/crossword-clue/1468455/Vacation-facility
Balneotherapy locale	http://www.crosswordgiant.com/crossword-clue/1469297/Balneotherapy-locale
Lake Manitou, for one	http://www.crosswordgiant.com/crossword-clue/1470453/Lake-Manitou-for-one
Where people lose on purpose	http://www.crosswordgiant.com/crossword-clue/1474697/Where-people-lose-on-purpose
Relaxing facility	http://www.crosswordgiant.com/crossword-clue/1494682/Relaxing-facility
Place to find sweaters?	http://www.crosswordgiant.com/crossword-clue/1497669/Place-to-find-sweaters
Where you might say ''ahh''	http://www.crosswordgiant.com/crossword-clue/1497941/Where-you-might-say-ahh
Reflexologist's place	http://www.crosswordgiant.com/crossword-clue/1499380/Reflexologists-place
Cruise-ship amenity, often	http://www.crosswordgiant.com/crossword-clue/1501888/Cruise-ship-amenity-often
