Kind of party	crosswordtracker.com/clue/kind-of-party/
Some like it hot	crosswordtracker.com/clue/some-like-it-hot/
Kind of bag	crosswordtracker.com/clue/kind-of-bag-2/
Coffee alternative	crosswordtracker.com/clue/coffee-alternative/
Hot drink	crosswordtracker.com/clue/hot-drink/
Herbal brew	crosswordtracker.com/clue/herbal-brew/
Afternoon social	crosswordtracker.com/clue/afternoon-social/
Sri Lanka export	crosswordtracker.com/clue/sri-lanka-export/
After-dinner drink	crosswordtracker.com/clue/after-dinner-drink/
Social event	crosswordtracker.com/clue/social-event/
Social	crosswordtracker.com/clue/social/
Herbal drink	crosswordtracker.com/clue/herbal-drink/
Caffeine source	crosswordtracker.com/clue/caffeine-source-2/
Kind of service	crosswordtracker.com/clue/kind-of-service/
Earl Grey, e.g.	crosswordtracker.com/clue/earl-grey-eg/
Chinese restaurant drink	crosswordtracker.com/clue/chinese-restaurant-drink/
Tetley product	crosswordtracker.com/clue/tetley-product/
Brewed beverage	crosswordtracker.com/clue/brewed-beverage/
Picker-upper	crosswordtracker.com/clue/picker-upper-2/
Afternoon break	crosswordtracker.com/clue/afternoon-break/
Sri Lankan export	crosswordtracker.com/clue/sri-lankan-export/
Mad Hatter's drink	crosswordtracker.com/clue/mad-hatters-drink/
Afternoon service	crosswordtracker.com/clue/afternoon-service/
Steeped beverage	crosswordtracker.com/clue/steeped-beverage-1/
Leaves in a bag	crosswordtracker.com/clue/leaves-in-a-bag/
It's in the bag	crosswordtracker.com/clue/its-in-the-bag/
It gets into hot water	crosswordtracker.com/clue/it-gets-into-hot-water/
Crumpets go-with	crosswordtracker.com/clue/crumpets-go-with/
Lipton product	crosswordtracker.com/clue/lipton-product/
___ rose	crosswordtracker.com/clue/___-rose-6/
Darjeeling, for one	crosswordtracker.com/clue/darjeeling-for-one/
Genteel affair	crosswordtracker.com/clue/genteel-affair/
Leaves for a drink	crosswordtracker.com/clue/leaves-for-a-drink-1/
___ party	crosswordtracker.com/clue/___-party-1/
Caddy's contents	crosswordtracker.com/clue/caddys-contents/
1773 jetsam	crosswordtracker.com/clue/1773-jetsam-1/
Oolong, e.g.	crosswordtracker.com/clue/oolong-eg/
Herbal beverage	crosswordtracker.com/clue/herbal-beverage/
Crumpets partner	crosswordtracker.com/clue/crumpets-partner/
Hyson, e.g.	crosswordtracker.com/clue/hyson-eg/
"Coffee or ___?"	crosswordtracker.com/clue/coffee-or-___/
Oolong, for one	crosswordtracker.com/clue/oolong-for-one/
Chinese restaurant beverage	crosswordtracker.com/clue/chinese-restaurant-beverage-1/
Hyson, for one	crosswordtracker.com/clue/hyson-for-one/
Society event	crosswordtracker.com/clue/society-event/
Afternoon affair	crosswordtracker.com/clue/afternoon-affair-1/
Lemon ___	crosswordtracker.com/clue/lemon-___/
Gunpowder, e.g.	crosswordtracker.com/clue/gunpowder-eg/
High ___	crosswordtracker.com/clue/high-___-7/
Type of bag	crosswordtracker.com/clue/type-of-bag-1/
High __	crosswordtracker.com/clue/high-__/
Contents of some bags	crosswordtracker.com/clue/contents-of-some-bags/
Black __	crosswordtracker.com/clue/black-__/
Party drink	crosswordtracker.com/clue/party-drink/
Society affair	crosswordtracker.com/clue/society-affair/
Break fluid?	crosswordtracker.com/clue/break-fluid/
Soho social	crosswordtracker.com/clue/soho-social/
Wonderland drink	crosswordtracker.com/clue/wonderland-drink/
Brighton brew	crosswordtracker.com/clue/brighton-brew/
Drink with crumpets	crosswordtracker.com/clue/drink-with-crumpets/
Chinese export	crosswordtracker.com/clue/chinese-export-1/
Leaves for a party?	crosswordtracker.com/clue/leaves-for-a-party/
It's served in spots	crosswordtracker.com/clue/its-served-in-spots/
Twinings product	crosswordtracker.com/clue/twinings-product/
Gunpowder, for one	crosswordtracker.com/clue/gunpowder-for-one/
Indian export	crosswordtracker.com/clue/indian-export/
Hot beverage	crosswordtracker.com/clue/hot-beverage-3/
Leaves in the bag	crosswordtracker.com/clue/leaves-in-the-bag/
Hot spot?	crosswordtracker.com/clue/hot-spot-1/
Social gathering	crosswordtracker.com/clue/social-gathering/
1773 jetsam in Boston Harbor	crosswordtracker.com/clue/1773-jetsam-in-boston-harbor/
It may be served in spots	crosswordtracker.com/clue/it-may-be-served-in-spots/
It's for two, in song	crosswordtracker.com/clue/its-for-two-in-song/
Oolong or pekoe	crosswordtracker.com/clue/oolong-or-pekoe/
Sympathy partner	crosswordtracker.com/clue/sympathy-partner/
Chinese beverage	crosswordtracker.com/clue/chinese-beverage/
Steeper?	crosswordtracker.com/clue/steeper/
Sympathy's partner	crosswordtracker.com/clue/sympathys-partner/
Leaves in the afternoon?	crosswordtracker.com/clue/leaves-in-the-afternoon/
Leaves in hot water	crosswordtracker.com/clue/leaves-in-hot-water/
Chinese drink	crosswordtracker.com/clue/chinese-drink/
Leaves in hot water?	crosswordtracker.com/clue/leaves-in-hot-water-1/
Drink with dim sum	crosswordtracker.com/clue/drink-with-dim-sum/
Leaves in the bag?	crosswordtracker.com/clue/leaves-in-the-bag-1/
Caddy's holding	crosswordtracker.com/clue/caddys-holding/
Afternoon event in Chelsea	crosswordtracker.com/clue/afternoon-event-in-chelsea/
Japanese ceremonial drink	crosswordtracker.com/clue/japanese-ceremonial-drink/
Earl Grey, for one	crosswordtracker.com/clue/earl-grey-for-one/
What some caddies hold	crosswordtracker.com/clue/what-some-caddies-hold/
Part of a baby bottle	crosswordtracker.com/clue/part-of-a-baby-bottle/
Kind of garden	crosswordtracker.com/clue/kind-of-garden/
Japanese drink	crosswordtracker.com/clue/japanese-drink/
Ubiquitous beverage	crosswordtracker.com/clue/ubiquitous-beverage/
Beverage order	crosswordtracker.com/clue/beverage-order/
Genteel gathering	crosswordtracker.com/clue/genteel-gathering/
Pekoe, for instance	crosswordtracker.com/clue/pekoe-for-instance/
Beverage for two?	crosswordtracker.com/clue/beverage-for-two/
It goes with crumpets	crosswordtracker.com/clue/it-goes-with-crumpets/
Social type	crosswordtracker.com/clue/social-type/
Mad Hatter's serving	crosswordtracker.com/clue/mad-hatters-serving/
Jasmine, for one	crosswordtracker.com/clue/jasmine-for-one/
Leaves for a drink?	crosswordtracker.com/clue/leaves-for-a-drink/
Nonalcoholic brew	crosswordtracker.com/clue/nonalcoholic-brew/
Leaves in bags	crosswordtracker.com/clue/leaves-in-bags/
Herb __	crosswordtracker.com/clue/herb-__/
Common make-believe drink	crosswordtracker.com/clue/common-make-believe-drink/
Green beverage	crosswordtracker.com/clue/green-beverage/
Chanoyu ritual drink	crosswordtracker.com/clue/chanoyu-ritual-drink/
Afternoon party	crosswordtracker.com/clue/afternoon-party/
Sleepytime or gunpowder	crosswordtracker.com/clue/sleepytime-or-gunpowder/
Black or green drink	crosswordtracker.com/clue/black-or-green-drink/
Soho drink	crosswordtracker.com/clue/soho-drink/
It may be iced in warm weather	crosswordtracker.com/clue/it-may-be-iced-in-warm-weather/
English Breakfast, for one	crosswordtracker.com/clue/english-breakfast-for-one/
Pekoe, e.g.	crosswordtracker.com/clue/pekoe-eg/
Party drink?	crosswordtracker.com/clue/party-drink-1/
Reason for a service break at Wimbledon?	crosswordtracker.com/clue/reason-for-a-service-break-at-wimbledon/
Leaves after dinner?	crosswordtracker.com/clue/leaves-after-dinner/
Bagged leaves	crosswordtracker.com/clue/bagged-leaves-1/
Afternoon event	crosswordtracker.com/clue/afternoon-event-1/
Darjeeling or oolong	crosswordtracker.com/clue/darjeeling-or-oolong/
__ set	crosswordtracker.com/clue/__-set/
Hot herbal drink	crosswordtracker.com/clue/hot-herbal-drink-1/
Bag of leaves, perhaps	crosswordtracker.com/clue/bag-of-leaves-perhaps/
Social service?	crosswordtracker.com/clue/social-service-1/
Afternoon potful	crosswordtracker.com/clue/afternoon-potful/
It's bagged in the supermarket	crosswordtracker.com/clue/its-bagged-in-the-supermarket/
Earl Grey is one	crosswordtracker.com/clue/earl-grey-is-one/
Brighton break	crosswordtracker.com/clue/brighton-break/
Steeped stuff	crosswordtracker.com/clue/steeped-stuff/
Potable	crosswordtracker.com/clue/potable-4/
English break	crosswordtracker.com/clue/english-break-2/
Herbal remedy	crosswordtracker.com/clue/herbal-remedy-2/
Cricket drink	crosswordtracker.com/clue/cricket-drink/
Darjeeling, e.g.	crosswordtracker.com/clue/darjeeling-eg/
White-gloves affair	crosswordtracker.com/clue/white-gloves-affair/
Brit's beverage	crosswordtracker.com/clue/brits-beverage/
Rugby ritual	crosswordtracker.com/clue/rugby-ritual/
British beverage	crosswordtracker.com/clue/british-beverage/
Leaves in the pot	crosswordtracker.com/clue/leaves-in-the-pot/
Four spot?	crosswordtracker.com/clue/four-spot/
Boston __ Party	crosswordtracker.com/clue/boston-__-party/
Mad Hatter's beverage	crosswordtracker.com/clue/mad-hatters-beverage/
Brit's break	crosswordtracker.com/clue/brits-break/
Crumpet chaser	crosswordtracker.com/clue/crumpet-chaser/
Spot in the afternoon?	crosswordtracker.com/clue/spot-in-the-afternoon/
4:00 social	crosswordtracker.com/clue/400-social/
Traditional beverage	crosswordtracker.com/clue/traditional-beverage/
Texas __: oil	crosswordtracker.com/clue/texas-__-oil/
Drink from a bag	crosswordtracker.com/clue/drink-from-a-bag/
__ party	crosswordtracker.com/clue/__-party-1/
Afternoon drink	crosswordtracker.com/clue/afternoon-drink/
Lipton's line	crosswordtracker.com/clue/liptons-line/
Scone accompaniment	crosswordtracker.com/clue/scone-accompaniment/
Cozy cupful	crosswordtracker.com/clue/cozy-cupful/
Word with spoon or cup	crosswordtracker.com/clue/word-with-spoon-or-cup/
Red Rose beverage	crosswordtracker.com/clue/red-rose-beverage/
Afternoon refreshment	crosswordtracker.com/clue/afternoon-refreshment/
The Mad Hatter's beverage	crosswordtracker.com/clue/the-mad-hatters-beverage/
Party still celebrated in Boston	crosswordtracker.com/clue/party-still-celebrated-in-boston/
Ceylon black, e.g.	crosswordtracker.com/clue/ceylon-black-eg/
Twinings offering	crosswordtracker.com/clue/twinings-offering-1/
Afternoon serving	crosswordtracker.com/clue/afternoon-serving/
Cozy drink?	crosswordtracker.com/clue/cozy-drink/
A&P's original business	crosswordtracker.com/clue/aps-original-business/
Leaves with a caddy?	crosswordtracker.com/clue/leaves-with-a-caddy/
Orange pekoe, for one	crosswordtracker.com/clue/orange-pekoe-for-one/
__ leaf	crosswordtracker.com/clue/__-leaf/
Afternoon reception	crosswordtracker.com/clue/afternoon-reception/
Social brew	crosswordtracker.com/clue/social-brew/
Drink served in spots?	crosswordtracker.com/clue/drink-served-in-spots/
Something brewing?	crosswordtracker.com/clue/something-brewing/
Scone go-with	crosswordtracker.com/clue/scone-go-with/
Beverage often served with sugar or lemon	crosswordtracker.com/clue/beverage-often-served-with-sugar-or-lemon/
Celestial Seasonings product	crosswordtracker.com/clue/celestial-seasonings-product/
Chamomile beverage	crosswordtracker.com/clue/chamomile-beverage/
Quaint get-together	crosswordtracker.com/clue/quaint-get-together/
Pekoe, for one	crosswordtracker.com/clue/pekoe-for-one/
Mad Hatter's offering	crosswordtracker.com/clue/mad-hatters-offering/
Word with garden or party	crosswordtracker.com/clue/word-with-garden-or-party/
It's often iced in summer	crosswordtracker.com/clue/its-often-iced-in-summer/
Green or sassafras	crosswordtracker.com/clue/green-or-sassafras/
Pekoe or Darjeeling	crosswordtracker.com/clue/pekoe-or-darjeeling/
You may have a spot of it	crosswordtracker.com/clue/you-may-have-a-spot-of-it/
Kind of bag for leaves?	crosswordtracker.com/clue/kind-of-bag-for-leaves/
Hatter affair	crosswordtracker.com/clue/hatter-affair/
Drink "for two"	crosswordtracker.com/clue/drink-for-two/
It may be in the bag	crosswordtracker.com/clue/it-may-be-in-the-bag/
It may be high in the afternoon	crosswordtracker.com/clue/it-may-be-high-in-the-afternoon/
After-dinner serving	crosswordtracker.com/clue/after-dinner-serving-2/
This is popular in spots	crosswordtracker.com/clue/this-is-popular-in-spots/
4:00 gathering	crosswordtracker.com/clue/400-gathering/
Contents of some small bags	crosswordtracker.com/clue/contents-of-some-small-bags/
Oolong or souchong	crosswordtracker.com/clue/oolong-or-souchong/
__ bag	crosswordtracker.com/clue/__-bag/
Cachar, e.g.	crosswordtracker.com/clue/cachar-eg/
Mythical Irish queen	crosswordtracker.com/clue/mythical-irish-queen/
Hyson or oopak	crosswordtracker.com/clue/hyson-or-oopak/
British ritual	crosswordtracker.com/clue/british-ritual/
Herbal soother	crosswordtracker.com/clue/herbal-soother/
Leaves in the cup	crosswordtracker.com/clue/leaves-in-the-cup/
Congou, e.g.	crosswordtracker.com/clue/congou-eg/
Spot in front of the telly?	crosswordtracker.com/clue/spot-in-front-of-the-telly/
Afternoon meal	crosswordtracker.com/clue/afternoon-meal-1/
Caddy contents	crosswordtracker.com/clue/caddy-contents/
Word with ball or bag	crosswordtracker.com/clue/word-with-ball-or-bag/
Bubble ___	crosswordtracker.com/clue/bubble-___/
____ Creek, Saskatchewan	crosswordtracker.com/clue/____-creek-saskatchewan/
Boston castoff	crosswordtracker.com/clue/boston-castoff/
Long Island drink	crosswordtracker.com/clue/long-island-drink/
It comes in bags	crosswordtracker.com/clue/it-comes-in-bags/
British import	crosswordtracker.com/clue/british-import-1/
Break in London	crosswordtracker.com/clue/break-in-london/
Oolong, for instance	crosswordtracker.com/clue/oolong-for-instance/
Drink available in black, white, green and red	crosswordtracker.com/clue/drink-available-in-black-white-green-and-red/
Stuff in a ball	crosswordtracker.com/clue/stuff-in-a-ball/
Word with ball or party	crosswordtracker.com/clue/word-with-ball-or-party/
It may be taken in the afternoon	crosswordtracker.com/clue/it-may-be-taken-in-the-afternoon/
Leaves from China, often	crosswordtracker.com/clue/leaves-from-china-often/
Leaves with dessert?	crosswordtracker.com/clue/leaves-with-dessert/
Submerged leaves	crosswordtracker.com/clue/submerged-leaves/
Dainty beverage	crosswordtracker.com/clue/dainty-beverage/
Small bag of buds that might chill you out	crosswordtracker.com/clue/small-bag-of-buds-that-might-chill-you-out/
Pot substance	crosswordtracker.com/clue/pot-substance/
Drink from Tazo	crosswordtracker.com/clue/drink-from-tazo/
Historic Boston Harbor flotsam	crosswordtracker.com/clue/historic-boston-harbor-flotsam/
It can be for two or for the Tillerman	crosswordtracker.com/clue/it-can-be-for-two-or-for-the-tillerman/
Texas __: petroleum	crosswordtracker.com/clue/texas-__-petroleum/
Spot from a pot?	crosswordtracker.com/clue/spot-from-a-pot/
Word after beef or cream	crosswordtracker.com/clue/word-after-beef-or-cream/
Leaves in a cup	crosswordtracker.com/clue/leaves-in-a-cup/
Word with ''bag'' or ''caddy''	crosswordtracker.com/clue/word-with-bag-or-caddy/
Drink with a scone	crosswordtracker.com/clue/drink-with-a-scone/
It was once harbored in Boston?	crosswordtracker.com/clue/it-was-once-harbored-in-boston/
Wonderland spot	crosswordtracker.com/clue/wonderland-spot/
Pekoe or green	crosswordtracker.com/clue/pekoe-or-green/
Hunan or dynamite	crosswordtracker.com/clue/hunan-or-dynamite/
It may be bagged	crosswordtracker.com/clue/it-may-be-bagged/
Cup with crumpets	crosswordtracker.com/clue/cup-with-crumpets/
Something steeped	crosswordtracker.com/clue/something-steeped/
Social beverage	crosswordtracker.com/clue/social-beverage/
It's taken in spots	crosswordtracker.com/clue/its-taken-in-spots/
What the Mad Hatter served	crosswordtracker.com/clue/what-the-mad-hatter-served/
__ service	crosswordtracker.com/clue/__-service/
Bagged leaves?	crosswordtracker.com/clue/bagged-leaves/
It may be iced	crosswordtracker.com/clue/it-may-be-iced/
Pekoe purchase	crosswordtracker.com/clue/pekoe-purchase/
Cozy do	crosswordtracker.com/clue/cozy-do/
Herbal __	crosswordtracker.com/clue/herbal-__/
4:00 get-together, in London	crosswordtracker.com/clue/400-get-together-in-london/
Herbal concoction	crosswordtracker.com/clue/herbal-concoction/
It may require a cart and a caddy	crosswordtracker.com/clue/it-may-require-a-cart-and-a-caddy/
British East India Company product	crosswordtracker.com/clue/british-east-india-company-product/
Word with ball or caddy	crosswordtracker.com/clue/word-with-ball-or-caddy/
Sri Lankan crop	crosswordtracker.com/clue/sri-lankan-crop/
Kind of bag or ball	crosswordtracker.com/clue/kind-of-bag-or-ball/
Actress Leoni	crosswordtracker.com/clue/actress-leoni/
It was once harbored in Boston	crosswordtracker.com/clue/it-was-once-harbored-in-boston-1/
Between-meals reception	crosswordtracker.com/clue/between-meals-reception/
Beverage for a genteel affair, e.g.	crosswordtracker.com/clue/beverage-for-a-genteel-affair-eg/
Popular brew	crosswordtracker.com/clue/popular-brew/
Crumpets' colleague	crosswordtracker.com/clue/crumpets-colleague/
Mint __	crosswordtracker.com/clue/mint-__/
Hyson or oolong	crosswordtracker.com/clue/hyson-or-oolong/
March Hare's offering	crosswordtracker.com/clue/march-hares-offering/
Something bagged in the pantry	crosswordtracker.com/clue/something-bagged-in-the-pantry/
Black or green stuff	crosswordtracker.com/clue/black-or-green-stuff/
1773 Boston Harbor jetsam	crosswordtracker.com/clue/1773-boston-harbor-jetsam/
Drink in the afternoon	crosswordtracker.com/clue/drink-in-the-afternoon/
Word after green or gunpowder	crosswordtracker.com/clue/word-after-green-or-gunpowder/
With 76D, "Spanglish" star	crosswordtracker.com/clue/with-76d-spanglish-star/
It's steeped in tradition	crosswordtracker.com/clue/its-steeped-in-tradition/
Leaves in water?	crosswordtracker.com/clue/leaves-in-water/
Mad Hatter's quaff	crosswordtracker.com/clue/mad-hatters-quaff/
Surrey spot?	crosswordtracker.com/clue/surrey-spot/
Word before garden or party	crosswordtracker.com/clue/word-before-garden-or-party/
Major Indian export	crosswordtracker.com/clue/major-indian-export/
Its taxation was protested in 1773	crosswordtracker.com/clue/its-taxation-was-protested-in-1773/
Fortuneteller's leaves	crosswordtracker.com/clue/fortunetellers-leaves/
The Mad Hatter's drink	crosswordtracker.com/clue/the-mad-hatters-drink/
March Hare's offering to Alice	crosswordtracker.com/clue/march-hares-offering-to-alice/
Drink served hot or cold	crosswordtracker.com/clue/drink-served-hot-or-cold/
Texas ___ (oil)	crosswordtracker.com/clue/texas-___-oil/
It's measured in spots?	crosswordtracker.com/clue/its-measured-in-spots/
Dorset drink	crosswordtracker.com/clue/dorset-drink/
New York's Russian ___ Room	crosswordtracker.com/clue/new-yorks-russian-___-room/
4 p.m., in Kent	crosswordtracker.com/clue/4-pm-in-kent/
Leaves for the afternoon?	crosswordtracker.com/clue/leaves-for-the-afternoon/
''High'' beverage	crosswordtracker.com/clue/high-beverage/
Kettle contents	crosswordtracker.com/clue/kettle-contents/
What's in the bag?	crosswordtracker.com/clue/whats-in-the-bag/
It's bagged in the grocery store	crosswordtracker.com/clue/its-bagged-in-the-grocery-store/
Chanoyu drink	crosswordtracker.com/clue/chanoyu-drink/
Afternoon drink, for many	crosswordtracker.com/clue/afternoon-drink-for-many/
What some caddies carry	crosswordtracker.com/clue/what-some-caddies-carry/
"___ with Mussolini" (1999 film)	crosswordtracker.com/clue/___-with-mussolini-1999-film/
Leaves underwater?	crosswordtracker.com/clue/leaves-underwater/
Afternoon quaff	crosswordtracker.com/clue/afternoon-quaff/
Bagged beverage	crosswordtracker.com/clue/bagged-beverage/
Spot from a pot	crosswordtracker.com/clue/spot-from-a-pot-1/
Mid-afternoon drink	crosswordtracker.com/clue/mid-afternoon-drink/
It can be black or green	crosswordtracker.com/clue/it-can-be-black-or-green/
Darjeeling drink	crosswordtracker.com/clue/darjeeling-drink/
One may be high at four	crosswordtracker.com/clue/one-may-be-high-at-four/
4:00 London social	crosswordtracker.com/clue/400-london-social/
White-glove affair	crosswordtracker.com/clue/white-glove-affair/
Social drink	crosswordtracker.com/clue/social-drink/
Kettle filler	crosswordtracker.com/clue/kettle-filler/
Pick-me-up cupful	crosswordtracker.com/clue/pick-me-up-cupful/
Crumpets' partner	crosswordtracker.com/clue/crumpets-partner-1/
Drink with a string in it, perhaps	crosswordtracker.com/clue/drink-with-a-string-in-it-perhaps/
Beverage with scones	crosswordtracker.com/clue/beverage-with-scones/
Orange pekoe, e.g.	crosswordtracker.com/clue/orange-pekoe-eg/
Wonderland beverage	crosswordtracker.com/clue/wonderland-beverage/
Big export from Sri Lanka	crosswordtracker.com/clue/big-export-from-sri-lanka/
"Iced" drink	crosswordtracker.com/clue/iced-drink-2/
It's bagged at the market	crosswordtracker.com/clue/its-bagged-at-the-market/
Drink in a pot	crosswordtracker.com/clue/drink-in-a-pot/
Drink served in "spots"	crosswordtracker.com/clue/drink-served-in-spots-1/
The British often take it	crosswordtracker.com/clue/the-british-often-take-it/
Crumpet accompaniment	crosswordtracker.com/clue/crumpet-accompaniment/
Beverage with crumpets	crosswordtracker.com/clue/beverage-with-crumpets/
It may be sun-brewed	crosswordtracker.com/clue/it-may-be-sun-brewed/
Afternoon drink, for some	crosswordtracker.com/clue/afternoon-drink-for-some/
Oolong or darjeeling	crosswordtracker.com/clue/oolong-or-darjeeling/
Something to take in the afternoon	crosswordtracker.com/clue/something-to-take-in-the-afternoon/
Coventry cupful	crosswordtracker.com/clue/coventry-cupful/
Hot or iced drink	crosswordtracker.com/clue/hot-or-iced-drink-1/
What the Mad Hatter pours on the Dormouse to wake it up	crosswordtracker.com/clue/what-the-mad-hatter-pours-on-the-dormouse-to-wake-it-up/
___ Party movement	crosswordtracker.com/clue/___-party-movement/
Afternoon meal, across the pond	crosswordtracker.com/clue/afternoon-meal-across-the-pond/
Breakfast cupful	crosswordtracker.com/clue/breakfast-cupful/
Crumpet's go-with	crosswordtracker.com/clue/crumpets-go-with-1/
Kind of party for Glenn Beck?	crosswordtracker.com/clue/kind-of-party-for-glenn-beck/
Event at which some people wear gloves	crosswordtracker.com/clue/event-at-which-some-people-wear-gloves/
"___ With Mussolini" (Zeffirelli film)	crosswordtracker.com/clue/___-with-mussolini-zeffirelli-film/
What the Hatter and the March Hare drank	crosswordtracker.com/clue/what-the-hatter-and-the-march-hare-drank/
Samovar beverage	crosswordtracker.com/clue/samovar-beverage/
4:00 drink	crosswordtracker.com/clue/400-drink/
Kind of cart	crosswordtracker.com/clue/kind-of-cart-2/
Something overthrown shortly before the American Revolution	crosswordtracker.com/clue/something-overthrown-shortly-before-the-american-revolution/
What's brewing, perhaps	crosswordtracker.com/clue/whats-brewing-perhaps/
Alternative to coffee	crosswordtracker.com/clue/alternative-to-coffee/
What some balls are filled with	crosswordtracker.com/clue/what-some-balls-are-filled-with/
Garden party, maybe	crosswordtracker.com/clue/garden-party-maybe/
Scone's go-with	crosswordtracker.com/clue/scones-go-with/
___ Party Nation	crosswordtracker.com/clue/___-party-nation/
Type of leaf or service	crosswordtracker.com/clue/type-of-leaf-or-service/
Leaves in the water?	crosswordtracker.com/clue/leaves-in-the-water/
Drink from leaves	crosswordtracker.com/clue/drink-from-leaves/
Beverage often served with lemon	crosswordtracker.com/clue/beverage-often-served-with-lemon/
Lipton drink	crosswordtracker.com/clue/lipton-drink/
British East India Co. monopoly	crosswordtracker.com/clue/british-east-india-co-monopoly/
Word with "service" or "ceremony"	crosswordtracker.com/clue/word-with-service-or-ceremony/
Oolong or Earl Grey	crosswordtracker.com/clue/oolong-or-earl-grey/
Earl or Lady Grey	crosswordtracker.com/clue/earl-or-lady-grey/
Word with cozy or bag	crosswordtracker.com/clue/word-with-cozy-or-bag/
4:00 English drink	crosswordtracker.com/clue/400-english-drink/
Drink offered to Alice	crosswordtracker.com/clue/drink-offered-to-alice/
Tazo product	crosswordtracker.com/clue/tazo-product/
Four O'Clock is a brand of it	crosswordtracker.com/clue/four-oclock-is-a-brand-of-it/
"When I Take My Sugar to __": 1931 hit	crosswordtracker.com/clue/when-i-take-my-sugar-to-__-1931-hit/
It may be green or black	crosswordtracker.com/clue/it-may-be-green-or-black/
Afternoon cup	crosswordtracker.com/clue/afternoon-cup-1/
Something sipped with a scone	crosswordtracker.com/clue/something-sipped-with-a-scone/
Brewed drink (found in all four long answers)	crosswordtracker.com/clue/brewed-drink-found-in-all-four-long-answers/
4 o'clock refreshment	crosswordtracker.com/clue/4-oclock-refreshment/
Type of service or caddy	crosswordtracker.com/clue/type-of-service-or-caddy/
Hot brew	crosswordtracker.com/clue/hot-brew/
Afternoon social event	crosswordtracker.com/clue/afternoon-social-event/
Kenyan export	crosswordtracker.com/clue/kenyan-export/
Type of spoon or cup	crosswordtracker.com/clue/type-of-spoon-or-cup/
Pekoe or oolong	crosswordtracker.com/clue/pekoe-or-oolong/
Lapsang souchong, e.g.	crosswordtracker.com/clue/lapsang-souchong-eg/
Service staple	crosswordtracker.com/clue/service-staple-1/
Spot in a pot	crosswordtracker.com/clue/spot-in-a-pot/
4:00 affair	crosswordtracker.com/clue/400-affair/
It may be taken in spots	crosswordtracker.com/clue/it-may-be-taken-in-spots/
A cuppa	crosswordtracker.com/clue/a-cuppa/
Genteel event	crosswordtracker.com/clue/genteel-event/
It may be spiced	crosswordtracker.com/clue/it-may-be-spiced/
Flight attendant's offering	crosswordtracker.com/clue/flight-attendants-offering/
Brewer's brew	crosswordtracker.com/clue/brewers-brew/
Word with caddy or bag	crosswordtracker.com/clue/word-with-caddy-or-bag/
___ caddy	crosswordtracker.com/clue/___-caddy/
Word with black or green	crosswordtracker.com/clue/word-with-black-or-green/
It may be brewing	crosswordtracker.com/clue/it-may-be-brewing/
It may be iced or spiced	crosswordtracker.com/clue/it-may-be-iced-or-spiced/
Blue mountain ___ (goldenrod)	crosswordtracker.com/clue/blue-mountain-___-goldenrod/
Britain's ___ Act of 1773	crosswordtracker.com/clue/britains-___-act-of-1773/
Midafternoon repast	crosswordtracker.com/clue/midafternoon-repast/
Product once harbored in Boston?	crosswordtracker.com/clue/product-once-harbored-in-boston/
Good source of antioxidants	crosswordtracker.com/clue/good-source-of-antioxidants/
Green brew	crosswordtracker.com/clue/green-brew/
It may be served with crumpets	crosswordtracker.com/clue/it-may-be-served-with-crumpets/
It may be herbal	crosswordtracker.com/clue/it-may-be-herbal/
Drink with one lump or two	crosswordtracker.com/clue/drink-with-one-lump-or-two/
Long Island Iced ___	crosswordtracker.com/clue/long-island-iced-___/
Samovar serving	crosswordtracker.com/clue/samovar-serving/
Hot spot, in lunch counter lingo	crosswordtracker.com/clue/hot-spot-in-lunch-counter-lingo/
Small bag of leaves	crosswordtracker.com/clue/small-bag-of-leaves/
Leaves at 4:00?	crosswordtracker.com/clue/leaves-at-400/
It may be black or green	crosswordtracker.com/clue/it-may-be-black-or-green/
4:00, in Kent	crosswordtracker.com/clue/400-in-kent/
Parlor drink	crosswordtracker.com/clue/parlor-drink/
Jetsam of 1773	crosswordtracker.com/clue/jetsam-of-1773/
Iced ___	crosswordtracker.com/clue/iced-___/
After-dinner offering	crosswordtracker.com/clue/after-dinner-offering/
Old-fashioned cold remedy	crosswordtracker.com/clue/old-fashioned-cold-remedy/
Kind of cozy	crosswordtracker.com/clue/kind-of-cozy/
Hot brewed beverage	crosswordtracker.com/clue/hot-brewed-beverage/
Party serving	crosswordtracker.com/clue/party-serving/
Drink in a cup	crosswordtracker.com/clue/drink-in-a-cup/
Afternoon social gathering	crosswordtracker.com/clue/afternoon-social-gathering/
Export of India	crosswordtracker.com/clue/export-of-india/
4 p.m. refreshment, perhaps	crosswordtracker.com/clue/4-pm-refreshment-perhaps/
Party quaff?	crosswordtracker.com/clue/party-quaff/
Major Kenyan export	crosswordtracker.com/clue/major-kenyan-export/
Afternoon brew	crosswordtracker.com/clue/afternoon-brew/
A social	crosswordtracker.com/clue/a-social-3/
Assam, e.g.	crosswordtracker.com/clue/assam-eg/
Souchong or hyson	crosswordtracker.com/clue/souchong-or-hyson/
Bohea or congou	crosswordtracker.com/clue/bohea-or-congou/
Spanish torch	crosswordtracker.com/clue/spanish-torch/
An infusion	crosswordtracker.com/clue/an-infusion/
Hyson is one	crosswordtracker.com/clue/hyson-is-one/
Elevenses, in England	crosswordtracker.com/clue/elevenses-in-england/
P.M. refreshment	crosswordtracker.com/clue/pm-refreshment/
Bohea, e.g.	crosswordtracker.com/clue/bohea-eg/
_____ service	crosswordtracker.com/clue/_____-service/
4:00 function	crosswordtracker.com/clue/400-function/
One may be high at 5:00	crosswordtracker.com/clue/one-may-be-high-at-500/
Red Rose, e.g.	crosswordtracker.com/clue/red-rose-eg/
Chow mein chaser	crosswordtracker.com/clue/chow-mein-chaser-1/
Cause of a restaurant stir?	crosswordtracker.com/clue/cause-of-a-restaurant-stir/
Kind of wagon or pot	crosswordtracker.com/clue/kind-of-wagon-or-pot/
Elevenses in London	crosswordtracker.com/clue/elevenses-in-london/
Elevenses in Elstree	crosswordtracker.com/clue/elevenses-in-elstree/
Congou or cachar	crosswordtracker.com/clue/congou-or-cachar/
Congou	crosswordtracker.com/clue/congou-2/
Hyson or souchong	crosswordtracker.com/clue/hyson-or-souchong/
Revolutionary party jetsam	crosswordtracker.com/clue/revolutionary-party-jetsam/
Jasmine or twankay	crosswordtracker.com/clue/jasmine-or-twankay/
Afternoon gathering	crosswordtracker.com/clue/afternoon-gathering-1/
Souchong, for one	crosswordtracker.com/clue/souchong-for-one/
Gunpowder or Twankay	crosswordtracker.com/clue/gunpowder-or-twankay/
Gowiddie, e.g.	crosswordtracker.com/clue/gowiddie-eg/
Assam, for one	crosswordtracker.com/clue/assam-for-one/
Bohea or bancha	crosswordtracker.com/clue/bohea-or-bancha/
___ and Sympathy (Robert Anderson play)	crosswordtracker.com/clue/___-and-sympathy-robert-anderson-play/
Soho social event	crosswordtracker.com/clue/soho-social-event/
Camellia sinensis product	crosswordtracker.com/clue/camellia-sinensis-product/
Robert Andersons ___ and Sympathy	crosswordtracker.com/clue/robert-andersons-___-and-sympathy/
"___ for Two"	crosswordtracker.com/clue/___-for-two/
Twankay, e.g.	crosswordtracker.com/clue/twankay-eg/
It can be green or black	crosswordtracker.com/clue/it-can-be-green-or-black/
Sushi bar quaff	crosswordtracker.com/clue/sushi-bar-quaff/
Sipped beverage	crosswordtracker.com/clue/sipped-beverage/
Congou, for example	crosswordtracker.com/clue/congou-for-example/
A caddy might hold it	crosswordtracker.com/clue/a-caddy-might-hold-it/
The East India Company traded in it	crosswordtracker.com/clue/the-east-india-company-traded-in-it/
Drink served with crumpets	crosswordtracker.com/clue/drink-served-with-crumpets/
Nanny ___ (folk remedy of sheep manure in hot water)	crosswordtracker.com/clue/nanny-___-folk-remedy-of-sheep-manure-in-hot-water/
Word with towel or service	crosswordtracker.com/clue/word-with-towel-or-service/
Word with rose or garden	crosswordtracker.com/clue/word-with-rose-or-garden/
Darjeeling, for example	crosswordtracker.com/clue/darjeeling-for-example/
"___ and Sympathy"	crosswordtracker.com/clue/___-and-sympathy-1/
Earl Grey, for example	crosswordtracker.com/clue/earl-grey-for-example/
Afternoon repast	crosswordtracker.com/clue/afternoon-repast/
Sympathy accompanier	crosswordtracker.com/clue/sympathy-accompanier/
Orange pekoe, for example	crosswordtracker.com/clue/orange-pekoe-for-example/
Hot pot contents	crosswordtracker.com/clue/hot-pot-contents/
Original cargo of the Cutty Sark	crosswordtracker.com/clue/original-cargo-of-the-cutty-sark/
Its bubble variety includes tapioca balls	crosswordtracker.com/clue/its-bubble-variety-includes-tapioca-balls/
Drink in a ceremony	crosswordtracker.com/clue/drink-in-a-ceremony/
Tazo, e.g.	crosswordtracker.com/clue/tazo-eg/
Drink in England	crosswordtracker.com/clue/drink-in-england/
Drawing room event	crosswordtracker.com/clue/drawing-room-event-1/
Common beverage	crosswordtracker.com/clue/common-beverage/
____ as it should be	crosswordtracker.com/clue/____-as-it-should-be/
Winter warmer upper	crosswordtracker.com/clue/winter-warmer-upper-1/
Pekoe	crosswordtracker.com/clue/pekoe-19/
____ For Two	crosswordtracker.com/clue/____-for-two/
English Breakfast or Orange Pekoe	crosswordtracker.com/clue/english-breakfast-or-orange-pekoe/
Djarling or Pekoe	crosswordtracker.com/clue/djarling-or-pekoe/
____ as it should be!	crosswordtracker.com/clue/____-as-it-should-be-1/
Pekoe or Djarling	crosswordtracker.com/clue/pekoe-or-djarling/
Afternoon ritual	crosswordtracker.com/clue/afternoon-ritual-1/
Pekoe,for one	crosswordtracker.com/clue/pekoefor-one/
Beverage served hot or cold	crosswordtracker.com/clue/beverage-served-hot-or-cold/
Crumpet companion	crosswordtracker.com/clue/crumpet-companion/
Caffeine provider	crosswordtracker.com/clue/caffeine-provider/
Start with spoons and cups?	crosswordtracker.com/clue/start-with-spoons-and-cups/
Word with bag or cup	crosswordtracker.com/clue/word-with-bag-or-cup/
Word with cake or party	crosswordtracker.com/clue/word-with-cake-or-party/
British time	crosswordtracker.com/clue/british-time/
A perk-me-up?	crosswordtracker.com/clue/a-perk-me-up/
Time in London?	crosswordtracker.com/clue/time-in-london/
Kind of cozy?	crosswordtracker.com/clue/kind-of-cozy-1/
The supermarket has bags and bags of it	crosswordtracker.com/clue/the-supermarket-has-bags-and-bags-of-it/
"Coffee, --- or me?"	crosswordtracker.com/clue/coffee-or-me/
Buy it by the bagful	crosswordtracker.com/clue/buy-it-by-the-bagful/
Crumpets' go-with	crosswordtracker.com/clue/crumpets-go-with-2/
Sympathy's partner?	crosswordtracker.com/clue/sympathys-partner-1/
Crumpets companion	crosswordtracker.com/clue/crumpets-companion/
Herb or mint	crosswordtracker.com/clue/herb-or-mint/
It may be for two	crosswordtracker.com/clue/it-may-be-for-two/
Congou or souchong	crosswordtracker.com/clue/congou-or-souchong/
Boston brew?	crosswordtracker.com/clue/boston-brew/
British break	crosswordtracker.com/clue/british-break-2/
It's effective when it gets in hot water	crosswordtracker.com/clue/its-effective-when-it-gets-in-hot-water/
4:00 event, in London	crosswordtracker.com/clue/400-event-in-london/
Leaves for the future?	crosswordtracker.com/clue/leaves-for-the-future/
Drink with a bag	crosswordtracker.com/clue/drink-with-a-bag/
Caffeinated brew	crosswordtracker.com/clue/caffeinated-brew/
Leaves for a drink from a bag?	crosswordtracker.com/clue/leaves-for-a-drink-from-a-bag/
Beverage choice	crosswordtracker.com/clue/beverage-choice/
Break in England	crosswordtracker.com/clue/break-in-england/
Leaves for a break?	crosswordtracker.com/clue/leaves-for-a-break/
It's bagged in the supermarket, often	crosswordtracker.com/clue/its-bagged-in-the-supermarket-often/
It comes in bags, often	crosswordtracker.com/clue/it-comes-in-bags-often/
Four o'clock serving, perhaps	crosswordtracker.com/clue/four-oclock-serving-perhaps/
Souchong, e.g.	crosswordtracker.com/clue/souchong-eg/
Sri Lanka crop	crosswordtracker.com/clue/sri-lanka-crop/
Pot product	crosswordtracker.com/clue/pot-product/
Leaves for the diner	crosswordtracker.com/clue/leaves-for-the-diner/
English breakfast, e.g.	crosswordtracker.com/clue/english-breakfast-eg/
Pot leaves	crosswordtracker.com/clue/pot-leaves/
Surrey sip	crosswordtracker.com/clue/surrey-sip/
Celestial Seasonings offering	crosswordtracker.com/clue/celestial-seasonings-offering/
Bigelow offering	crosswordtracker.com/clue/bigelow-offering/
Leaves held in the bag	crosswordtracker.com/clue/leaves-held-in-the-bag/
Party for Palin	crosswordtracker.com/clue/party-for-palin/
Four o'clock drink	crosswordtracker.com/clue/four-oclock-drink/
Pekoe or Assam	crosswordtracker.com/clue/pekoe-or-assam/
Spot in the United Kingdom?	crosswordtracker.com/clue/spot-in-the-united-kingdom/
One way to take opium	crosswordtracker.com/clue/one-way-to-take-opium/
Stash offering	crosswordtracker.com/clue/stash-offering/
Pinky-out drink	crosswordtracker.com/clue/pinky-out-drink/
Jasmine or Monk's Blend	crosswordtracker.com/clue/jasmine-or-monks-blend/
Drink with its own character in the Chinese alphabet	crosswordtracker.com/clue/drink-with-its-own-character-in-the-chinese-alphabet/
Reefer, in slang	crosswordtracker.com/clue/reefer-in-slang/
Beverage for Wallace and Gromit	crosswordtracker.com/clue/beverage-for-wallace-and-gromit/
Bag contents, often	crosswordtracker.com/clue/bag-contents-often/
Leoni of "Tower Heist"	crosswordtracker.com/clue/leoni-of-tower-heist/
Leaves in cups	crosswordtracker.com/clue/leaves-in-cups/
Weak ___	crosswordtracker.com/clue/weak-___-3/
Leaves in the pantry	crosswordtracker.com/clue/leaves-in-the-pantry/
Chinese restaurant freebie	crosswordtracker.com/clue/chinese-restaurant-freebie-1/
It may be drunk at 4:00	crosswordtracker.com/clue/it-may-be-drunk-at-400/
Afternoon social	http://www.crosswordgiant.com/crossword-clue/156896/Afternoon-social
Afternoon affair	http://www.crosswordgiant.com/crossword-clue/253645/Afternoon-affair
Earl Grey, e.g.	http://www.crosswordgiant.com/crossword-clue/64869/Earl-Grey-e.g
Coffee alternative	http://www.crosswordgiant.com/crossword-clue/36900/Coffee-alternative
Brewed beverage	http://www.crosswordgiant.com/crossword-clue/234315/Brewed-beverage
Earl Grey, for one	http://www.crosswordgiant.com/crossword-clue/266549/Earl-Grey-for-one
Pot brew	http://www.crosswordgiant.com/crossword-clue/240883/Pot-brew
Hot drink	http://www.crosswordgiant.com/crossword-clue/80933/Hot-drink
Some like it hot	http://www.crosswordgiant.com/crossword-clue/71627/Some-like-it-hot
Afternoon get-together	http://www.crosswordgiant.com/crossword-clue/314714/Afternoon-get-together
Caffeine source	http://www.crosswordgiant.com/crossword-clue/25114/Caffeine-source
Pot fill	http://www.crosswordgiant.com/crossword-clue/298357/Pot-fill
Sri Lanka export	http://www.crosswordgiant.com/crossword-clue/26520/Sri-Lanka-export
Brewed drink	http://www.crosswordgiant.com/crossword-clue/86197/Brewed-drink
Assam export	http://www.crosswordgiant.com/crossword-clue/250101/Assam-export
Beverage from leaves	http://www.crosswordgiant.com/crossword-clue/1006448/Beverage-from-leaves
Steeped beverage	http://www.crosswordgiant.com/crossword-clue/66229/Steeped-beverage
Genteel affair	http://www.crosswordgiant.com/crossword-clue/40821/Genteel-affair
Leaves for a drink	http://www.crosswordgiant.com/crossword-clue/313985/Leaves-for-a-drink
Herbal brew	http://www.crosswordgiant.com/crossword-clue/317230/Herbal-brew
Brit's brew	http://www.crosswordgiant.com/crossword-clue/324394/Brits-brew
Tetley product	http://www.crosswordgiant.com/crossword-clue/10793/Tetley-product
Hyson, for one	http://www.crosswordgiant.com/crossword-clue/115488/Hyson-for-one
Darjeeling, for one	http://www.crosswordgiant.com/crossword-clue/241313/Darjeeling-for-one
Oolong, for one	http://www.crosswordgiant.com/crossword-clue/47080/Oolong-for-one
1773 jetsam	http://www.crosswordgiant.com/crossword-clue/62951/1773-jetsam
Leaves in a bag	http://www.crosswordgiant.com/crossword-clue/85788/Leaves-in-a-bag
Crumpets go-with	http://www.crosswordgiant.com/crossword-clue/143209/Crumpets-go-with
Chinese export	http://www.crosswordgiant.com/crossword-clue/192035/Chinese-export
Earl Grey, e.g	http://www.crosswordgiant.com/crossword-clue/1211997/Earl-Grey-e.g
Herbal drink	http://www.crosswordgiant.com/crossword-clue/11581/Herbal-drink
Gunpowder, for one	http://www.crosswordgiant.com/crossword-clue/125053/Gunpowder-for-one
Society affair	http://www.crosswordgiant.com/crossword-clue/128428/Society-affair
Mad Hatter's drink	http://www.crosswordgiant.com/crossword-clue/213063/Mad-Hatters-drink
Mad Hatter's quaff	http://www.crosswordgiant.com/crossword-clue/277409/Mad-Hatters-quaff
Drink with crumpets	http://www.crosswordgiant.com/crossword-clue/280272/Drink-with-crumpets
"Coffee or ___?"	http://www.crosswordgiant.com/crossword-clue/757952/Coffee-or-___
Social	http://www.crosswordgiant.com/crossword-clue/29372/Social
Wonderland drink	http://www.crosswordgiant.com/crossword-clue/34960/Wonderland-drink
British brew	http://www.crosswordgiant.com/crossword-clue/233837/British-brew
Orange pekoe, for one	http://www.crosswordgiant.com/crossword-clue/314313/Orange-pekoe-for-one
It's in the bag	http://www.crosswordgiant.com/crossword-clue/339276/Its-in-the-bag
Afternoon gathering	http://www.crosswordgiant.com/crossword-clue/355887/Afternoon-gathering
It's for two, in song	http://www.crosswordgiant.com/crossword-clue/412545/Its-for-two-in-song
Crumpets partner	http://www.crosswordgiant.com/crossword-clue/418587/Crumpets-partner
___ party	http://www.crosswordgiant.com/crossword-clue/817097/___-party
It's served in spots	http://www.crosswordgiant.com/crossword-clue/52631/Its-served-in-spots
Darjeeling or oolong	http://www.crosswordgiant.com/crossword-clue/68817/Darjeeling-or-oolong
It may be served in spots	http://www.crosswordgiant.com/crossword-clue/77860/It-may-be-served-in-spots
Caddy's holding	http://www.crosswordgiant.com/crossword-clue/80514/Caddys-holding
Afternoon event	http://www.crosswordgiant.com/crossword-clue/123232/Afternoon-event
Social event	http://www.crosswordgiant.com/crossword-clue/131033/Social-event
Leaves in the bag?	http://www.crosswordgiant.com/crossword-clue/150568/Leaves-in-the-bag
Drink from a bag	http://www.crosswordgiant.com/crossword-clue/152723/Drink-from-a-bag
Midafternoon social	http://www.crosswordgiant.com/crossword-clue/217828/Midafternoon-social
Afternoon party	http://www.crosswordgiant.com/crossword-clue/219302/Afternoon-party
Japanese ceremonial drink	http://www.crosswordgiant.com/crossword-clue/309763/Japanese-ceremonial-drink
Lipton product	http://www.crosswordgiant.com/crossword-clue/323948/Lipton-product
Steeped stuff	http://www.crosswordgiant.com/crossword-clue/491669/Steeped-stuff
Leaves in hot water	http://www.crosswordgiant.com/crossword-clue/555428/Leaves-in-hot-water
1773 jetsam in Boston Harbor	http://www.crosswordgiant.com/crossword-clue/604388/1773-jetsam-in-Boston-Harbor
Leaves in hot water?	http://www.crosswordgiant.com/crossword-clue/731746/Leaves-in-hot-water
Afternoon drink	http://www.crosswordgiant.com/crossword-clue/788083/Afternoon-drink
Popular drink	http://www.crosswordgiant.com/crossword-clue/978687/Popular-drink
It may be high in the afternoon	http://www.crosswordgiant.com/crossword-clue/1638/It-may-be-high-in-the-afternoon
Kind of party	http://www.crosswordgiant.com/crossword-clue/51439/Kind-of-party
Picker-upper	http://www.crosswordgiant.com/crossword-clue/52748/Picker-upper
Sri Lankan export	http://www.crosswordgiant.com/crossword-clue/68025/Sri-Lankan-export
Sympathy's partner	http://www.crosswordgiant.com/crossword-clue/109920/Sympathys-partner
Hyson, e.g.	http://www.crosswordgiant.com/crossword-clue/110905/Hyson-e.g
Beverage for two?	http://www.crosswordgiant.com/crossword-clue/137609/Beverage-for-two
Afternoon event in Chelsea	http://www.crosswordgiant.com/crossword-clue/144115/Afternoon-event-in-Chelsea
It gets into hot water	http://www.crosswordgiant.com/crossword-clue/144272/It-gets-into-hot-water
Oolong or pekoe	http://www.crosswordgiant.com/crossword-clue/170707/Oolong-or-pekoe
It's bagged in the supermarket	http://www.crosswordgiant.com/crossword-clue/210911/Its-bagged-in-the-supermarket
'-- and Sympathy'	http://www.crosswordgiant.com/crossword-clue/258566/-and-Sympathy
Mid-afternoon social	http://www.crosswordgiant.com/crossword-clue/260116/Mid-afternoon-social
Pekoe, e.g.	http://www.crosswordgiant.com/crossword-clue/295755/Pekoe-e.g
Chanoyu ritual drink	http://www.crosswordgiant.com/crossword-clue/296936/Chanoyu-ritual-drink
It comes in bags, often	http://www.crosswordgiant.com/crossword-clue/319158/It-comes-in-bags-often
Leaves in the bag	http://www.crosswordgiant.com/crossword-clue/322716/Leaves-in-the-bag
With 38-Across, Wonderland event	http://www.crosswordgiant.com/crossword-clue/322819/With-38-Across-Wonderland-event
High __	http://www.crosswordgiant.com/crossword-clue/342606/High-__
Sympathy partner	http://www.crosswordgiant.com/crossword-clue/355547/Sympathy-partner
Hot spot?	http://www.crosswordgiant.com/crossword-clue/383663/Hot-spot
Beverage	http://www.crosswordgiant.com/crossword-clue/392050/Beverage
Leaves in bags	http://www.crosswordgiant.com/crossword-clue/419016/Leaves-in-bags
Pekoe, for one	http://www.crosswordgiant.com/crossword-clue/425287/Pekoe-for-one
Hot brew	http://www.crosswordgiant.com/crossword-clue/440129/Hot-brew
Sleepytime or gunpowder	http://www.crosswordgiant.com/crossword-clue/443642/Sleepytime-or-gunpowder
Pekoe, for instance	http://www.crosswordgiant.com/crossword-clue/470078/Pekoe-for-instance
Chinese restaurant freebie	http://www.crosswordgiant.com/crossword-clue/474035/Chinese-restaurant-freebie
Social type	http://www.crosswordgiant.com/crossword-clue/534387/Social-type
Leaves after dinner?	http://www.crosswordgiant.com/crossword-clue/538205/Leaves-after-dinner
Genteel gathering	http://www.crosswordgiant.com/crossword-clue/598641/Genteel-gathering
Something brewing?	http://www.crosswordgiant.com/crossword-clue/613757/Something-brewing
Contents of some bags	http://www.crosswordgiant.com/crossword-clue/617304/Contents-of-some-bags
It goes with crumpets	http://www.crosswordgiant.com/crossword-clue/629947/It-goes-with-crumpets
Black or green drink	http://www.crosswordgiant.com/crossword-clue/756090/Black-or-green-drink
What some caddies hold	http://www.crosswordgiant.com/crossword-clue/825842/What-some-caddies-hold
Reason for a service break at Wimbledon?	http://www.crosswordgiant.com/crossword-clue/829756/Reason-for-a-service-break-at-Wimbledon
Eat the drink?	http://www.crosswordgiant.com/crossword-clue/987343/Eat-the-drink
Afternoon repast	http://www.crosswordgiant.com/crossword-clue/1030404/Afternoon-repast
Hot herbal drink	http://www.crosswordgiant.com/crossword-clue/1241458/Hot-herbal-drink
Afternoon social event	http://www.crosswordgiant.com/crossword-clue/1334326/Afternoon-social-event
Drink - meal	http://www.crosswordgiant.com/crossword-clue/1351918/Drink-meal
Afternoon brew	http://www.crosswordgiant.com/crossword-clue/1461245/Afternoon-brew
This is popular in spots	http://www.crosswordgiant.com/crossword-clue/13827/This-is-popular-in-spots
Afternoon service	http://www.crosswordgiant.com/crossword-clue/24649/Afternoon-service
Kind of service	http://www.crosswordgiant.com/crossword-clue/27933/Kind-of-service
Jasmine, for one	http://www.crosswordgiant.com/crossword-clue/28244/Jasmine-for-one
Jetsam of 1773	http://www.crosswordgiant.com/crossword-clue/39417/Jetsam-of-1773
Leaves for the afternoon?	http://www.crosswordgiant.com/crossword-clue/115919/Leaves-for-the-afternoon
British import	http://www.crosswordgiant.com/crossword-clue/124835/British-import
It may be in the bag	http://www.crosswordgiant.com/crossword-clue/127609/It-may-be-in-the-bag
Crumpet chaser	http://www.crosswordgiant.com/crossword-clue/153056/Crumpet-chaser
Party still celebrated in Boston	http://www.crosswordgiant.com/crossword-clue/167875/Party-still-celebrated-in-Boston
Herbal beverage	http://www.crosswordgiant.com/crossword-clue/180707/Herbal-beverage
Green beverage	http://www.crosswordgiant.com/crossword-clue/188200/Green-beverage
Boston castoff	http://www.crosswordgiant.com/crossword-clue/188729/Boston-castoff
Break in London	http://www.crosswordgiant.com/crossword-clue/191405/Break-in-London
Leaves for a party?	http://www.crosswordgiant.com/crossword-clue/191833/Leaves-for-a-party
Afternoon reception	http://www.crosswordgiant.com/crossword-clue/192305/Afternoon-reception
Herbal remedy	http://www.crosswordgiant.com/crossword-clue/202731/Herbal-remedy
Social drink	http://www.crosswordgiant.com/crossword-clue/203076/Social-drink
High ___	http://www.crosswordgiant.com/crossword-clue/213878/High-___
Ceylon Black, e.g.	http://www.crosswordgiant.com/crossword-clue/221771/Ceylon-Black-e.g
Pekoe or Darjeeling	http://www.crosswordgiant.com/crossword-clue/222244/Pekoe-or-Darjeeling
Social brew	http://www.crosswordgiant.com/crossword-clue/227554/Social-brew
Long Island drink	http://www.crosswordgiant.com/crossword-clue/232871/Long-Island-drink
The Mad Hatter's beverage	http://www.crosswordgiant.com/crossword-clue/236720/The-Mad-Hatters-beverage
'-- for Two'	http://www.crosswordgiant.com/crossword-clue/277643/-for-Two
Darjeeling, e.g.	http://www.crosswordgiant.com/crossword-clue/302130/Darjeeling-e.g
Alternative to coffee	http://www.crosswordgiant.com/crossword-clue/307464/Alternative-to-coffee
Four o'clock serving, perhaps	http://www.crosswordgiant.com/crossword-clue/320097/Four-oclock-serving-perhaps
Starbucks' offering	http://www.crosswordgiant.com/crossword-clue/321259/Starbucks-offering
What some balls are filled with	http://www.crosswordgiant.com/crossword-clue/322336/What-some-balls-are-filled-with
Garden party, maybe	http://www.crosswordgiant.com/crossword-clue/322439/Garden-party-maybe
A perk-me-up?	http://www.crosswordgiant.com/crossword-clue/324418/A-perk-me-up
Gunpowder, e.g.	http://www.crosswordgiant.com/crossword-clue/345017/Gunpowder-e.g
Wonderland quaff	http://www.crosswordgiant.com/crossword-clue/345744/Wonderland-quaff
Hot or iced drink	http://www.crosswordgiant.com/crossword-clue/347577/Hot-or-iced-drink
It's often iced in summer	http://www.crosswordgiant.com/crossword-clue/348779/Its-often-iced-in-summer
Kind of cozy?	http://www.crosswordgiant.com/crossword-clue/353015/Kind-of-cozy
4:00 social	http://www.crosswordgiant.com/crossword-clue/357447/400-social
Nonalcoholic brew	http://www.crosswordgiant.com/crossword-clue/363548/Nonalcoholic-brew
Tazo product	http://www.crosswordgiant.com/crossword-clue/364280/Tazo-product
Bagged leaves	http://www.crosswordgiant.com/crossword-clue/374828/Bagged-leaves
Rugby ritual	http://www.crosswordgiant.com/crossword-clue/375456/Rugby-ritual
Afternoon serving	http://www.crosswordgiant.com/crossword-clue/402565/Afternoon-serving
Pekoe or oolong	http://www.crosswordgiant.com/crossword-clue/404306/Pekoe-or-oolong
Chinese beverage	http://www.crosswordgiant.com/crossword-clue/431194/Chinese-beverage
Traditional beverage	http://www.crosswordgiant.com/crossword-clue/441140/Traditional-beverage
Common make-believe drink	http://www.crosswordgiant.com/crossword-clue/453155/Common-make-believe-drink
Boston __ Party	http://www.crosswordgiant.com/crossword-clue/476637/Boston-__-Party
You may have a spot of it	http://www.crosswordgiant.com/crossword-clue/487471/You-may-have-a-spot-of-it
Drink available in black, white, green and red	http://www.crosswordgiant.com/crossword-clue/501759/Drink-available-in-black-white-green-and-red
Brit's break	http://www.crosswordgiant.com/crossword-clue/508897/Brits-break
Leaves underwater?	http://www.crosswordgiant.com/crossword-clue/512438/Leaves-underwater
Four spot?	http://www.crosswordgiant.com/crossword-clue/541661/Four-spot
Spot in the afternoon?	http://www.crosswordgiant.com/crossword-clue/564121/Spot-in-the-afternoon
Boston -- Party	http://www.crosswordgiant.com/crossword-clue/567502/Boston-Party
White-gloves affair	http://www.crosswordgiant.com/crossword-clue/575885/White-gloves-affair
Party drink?	http://www.crosswordgiant.com/crossword-clue/580727/Party-drink
Brit's beverage	http://www.crosswordgiant.com/crossword-clue/581111/Brits-beverage
Pick-me-up cupful	http://www.crosswordgiant.com/crossword-clue/603657/Pick-me-up-cupful
Leaves in the pot	http://www.crosswordgiant.com/crossword-clue/620254/Leaves-in-the-pot
Leaves in a cup	http://www.crosswordgiant.com/crossword-clue/622898/Leaves-in-a-cup
Afternoon quaff	http://www.crosswordgiant.com/crossword-clue/630390/Afternoon-quaff
English Breakfast, for one	http://www.crosswordgiant.com/crossword-clue/637560/English-Breakfast-for-one
Break fluid?	http://www.crosswordgiant.com/crossword-clue/652813/Break-fluid
Beverage often served with sugar or lemon	http://www.crosswordgiant.com/crossword-clue/659042/Beverage-often-served-with-sugar-or-lemon
Party drink	http://www.crosswordgiant.com/crossword-clue/660864/Party-drink
Celestial Seasonings product	http://www.crosswordgiant.com/crossword-clue/666665/Celestial-Seasonings-product
Leaves with a caddy?	http://www.crosswordgiant.com/crossword-clue/705655/Leaves-with-a-caddy
Cricket drink	http://www.crosswordgiant.com/crossword-clue/725054/Cricket-drink
Caddy drink	http://www.crosswordgiant.com/crossword-clue/757680/Caddy-drink
Texas __: oil	http://www.crosswordgiant.com/crossword-clue/771775/Texas-__-oil
Mad Hatter's drink	http://www.crosswordgiant.com/crossword-clue/785864/Mad-Hatters-drink
Lipton drink	http://www.crosswordgiant.com/crossword-clue/786795/Lipton-drink
It may be iced in warm weather	http://www.crosswordgiant.com/crossword-clue/793792/It-may-be-iced-in-warm-weather
Caddy quaff	http://www.crosswordgiant.com/crossword-clue/798183/Caddy-quaff
Soho drink	http://www.crosswordgiant.com/crossword-clue/810708/Soho-drink
Drink with dim sum	http://www.crosswordgiant.com/crossword-clue/815614/Drink-with-dim-sum
Drink served in spots?	http://www.crosswordgiant.com/crossword-clue/825618/Drink-served-in-spots
Afternoon potful	http://www.crosswordgiant.com/crossword-clue/853301/Afternoon-potful
Drink from leaves	http://www.crosswordgiant.com/crossword-clue/888958/Drink-from-leaves
Afternoon beverage	http://www.crosswordgiant.com/crossword-clue/911260/Afternoon-beverage
Mad Hatter's offering	http://www.crosswordgiant.com/crossword-clue/928636/Mad-Hatters-offering
Word with garden or party	http://www.crosswordgiant.com/crossword-clue/933388/Word-with-garden-or-party
Drink for a meal	http://www.crosswordgiant.com/crossword-clue/950323/Drink-for-a-meal
Light afternoon meal	http://www.crosswordgiant.com/crossword-clue/1005866/Light-afternoon-meal
Light afternoon repast	http://www.crosswordgiant.com/crossword-clue/1029675/Light-afternoon-repast
Before you with the cup	http://www.crosswordgiant.com/crossword-clue/1141657/Before-you-with-the-cup
'Sounds before you come, sing afterwards annoyingly (3)'	http://www.crosswordgiant.com/crossword-clue/1176923/Sounds-before-you-come-sing-afterwards-annoyingly-3
'Sing after this, just to have you after it annoyingly (3)'	http://www.crosswordgiant.com/crossword-clue/1177325/Sing-after-this-just-to-have-you-after-it-annoyingly-3
A pro might get the blooming cup for this	http://www.crosswordgiant.com/crossword-clue/1183761/A-pro-might-get-the-blooming-cup-for-this
Sounds as if it's taken before you	http://www.crosswordgiant.com/crossword-clue/1184514/Sounds-as-if-its-taken-before-you
42 before you?	http://www.crosswordgiant.com/crossword-clue/1188466/42-before-you
Leaves make it before you, by the sound of it	http://www.crosswordgiant.com/crossword-clue/1189755/Leaves-make-it-before-you-by-the-sound-of-it
Leaves in the pot for this	http://www.crosswordgiant.com/crossword-clue/1190052/Leaves-in-the-pot-for-this
Oolong, e.g	http://www.crosswordgiant.com/crossword-clue/1221014/Oolong-e.g
Cha	http://www.crosswordgiant.com/crossword-clue/1371017/Cha
Kind of bag for leaves?	http://www.crosswordgiant.com/crossword-clue/1412339/Kind-of-bag-for-leaves
Contents of some small bags	http://www.crosswordgiant.com/crossword-clue/1452735/Contents-of-some-small-bags
Oolong, for example	http://www.crosswordgiant.com/crossword-clue/1483591/Oolong-for-example
Darjeeling, e.g	http://www.crosswordgiant.com/crossword-clue/1487835/Darjeeling-e.g
See 7-Down	http://www.crosswordgiant.com/crossword-clue/6471/See-7-Down
___ Rose	http://www.crosswordgiant.com/crossword-clue/14242/___-Rose
It may be black or green	http://www.crosswordgiant.com/crossword-clue/14440/It-may-be-black-or-green
After-dinner drink	http://www.crosswordgiant.com/crossword-clue/22179/After-dinner-drink
4:00, in Kent	http://www.crosswordgiant.com/crossword-clue/27562/400-in-Kent
Parlor drink	http://www.crosswordgiant.com/crossword-clue/30566/Parlor-drink
See 3-Down	http://www.crosswordgiant.com/crossword-clue/31045/See-3-Down
Iced ___	http://www.crosswordgiant.com/crossword-clue/40882/Iced-___
After-dinner offering	http://www.crosswordgiant.com/crossword-clue/43499/After-dinner-offering
Old-fashioned cold remedy	http://www.crosswordgiant.com/crossword-clue/45439/Old-fashioned-cold-remedy
See 15-Across	http://www.crosswordgiant.com/crossword-clue/47585/See-15-Across
Steeper?	http://www.crosswordgiant.com/crossword-clue/49106/Steeper
4:00 gathering	http://www.crosswordgiant.com/crossword-clue/51177/400-gathering
Kind of cozy	http://www.crosswordgiant.com/crossword-clue/52411/Kind-of-cozy
See 21-Across	http://www.crosswordgiant.com/crossword-clue/58364/See-21-Across
Twinings product	http://www.crosswordgiant.com/crossword-clue/62447/Twinings-product
Bubble ___	http://www.crosswordgiant.com/crossword-clue/65614/Bubble-___
Drink in a cup	http://www.crosswordgiant.com/crossword-clue/67126/Drink-in-a-cup
Afternoon break	http://www.crosswordgiant.com/crossword-clue/72991/Afternoon-break
It may be spiced	http://www.crosswordgiant.com/crossword-clue/76599/It-may-be-spiced
Part of a baby bottle	http://www.crosswordgiant.com/crossword-clue/78752/Part-of-a-baby-bottle
Social service?	http://www.crosswordgiant.com/crossword-clue/79887/Social-service
Flight attendant's offering	http://www.crosswordgiant.com/crossword-clue/81724/Flight-attendants-offering
Brewer's brew	http://www.crosswordgiant.com/crossword-clue/85140/Brewers-brew
It may be for two	http://www.crosswordgiant.com/crossword-clue/111190/It-may-be-for-two
Beverage order	http://www.crosswordgiant.com/crossword-clue/115028/Beverage-order
See 52-Across	http://www.crosswordgiant.com/crossword-clue/120595/See-52-Across
Word with caddy or bag	http://www.crosswordgiant.com/crossword-clue/122980/Word-with-caddy-or-bag
Leaves in the cup	http://www.crosswordgiant.com/crossword-clue/127815/Leaves-in-the-cup
Chinese restaurant drink	http://www.crosswordgiant.com/crossword-clue/130870/Chinese-restaurant-drink
Pot product	http://www.crosswordgiant.com/crossword-clue/135909/Pot-product
Congou or souchong	http://www.crosswordgiant.com/crossword-clue/135988/Congou-or-souchong
Boston brew?	http://www.crosswordgiant.com/crossword-clue/140149/Boston-brew
Kind of garden	http://www.crosswordgiant.com/crossword-clue/141905/Kind-of-garden
___ caddy	http://www.crosswordgiant.com/crossword-clue/143194/___-caddy
Word with black or green	http://www.crosswordgiant.com/crossword-clue/145467/Word-with-black-or-green
Indonesian export	http://www.crosswordgiant.com/crossword-clue/149742/Indonesian-export
It may be brewing	http://www.crosswordgiant.com/crossword-clue/151446/It-may-be-brewing
It may be iced or spiced	http://www.crosswordgiant.com/crossword-clue/153640/It-may-be-iced-or-spiced
Brighton break	http://www.crosswordgiant.com/crossword-clue/156236/Brighton-break
British break	http://www.crosswordgiant.com/crossword-clue/158430/British-break
First product of 53-Down	http://www.crosswordgiant.com/crossword-clue/161493/First-product-of-53-Down
It comes in bags	http://www.crosswordgiant.com/crossword-clue/170575/It-comes-in-bags
It's effective when it gets in hot water	http://www.crosswordgiant.com/crossword-clue/170703/Its-effective-when-it-gets-in-hot-water
4:00 event, in London	http://www.crosswordgiant.com/crossword-clue/170894/400-event-in-London
Leaves for the future?	http://www.crosswordgiant.com/crossword-clue/172295/Leaves-for-the-future
Hatter affair	http://www.crosswordgiant.com/crossword-clue/186949/Hatter-affair
A&P's original business	http://www.crosswordgiant.com/crossword-clue/187435/APs-original-business
Blue mountain ___ (goldenrod)	http://www.crosswordgiant.com/crossword-clue/189327/Blue-mountain-___-goldenrod
Drink with a bag	http://www.crosswordgiant.com/crossword-clue/189336/Drink-with-a-bag
Quaint get-together	http://www.crosswordgiant.com/crossword-clue/189442/Quaint-get-together
Chinese drink	http://www.crosswordgiant.com/crossword-clue/195639/Chinese-drink
Caffeinated brew	http://www.crosswordgiant.com/crossword-clue/207840/Caffeinated-brew
Lemon ___	http://www.crosswordgiant.com/crossword-clue/207954/Lemon-___
Britain's ___ Act of 1773	http://www.crosswordgiant.com/crossword-clue/210673/Britains-___-Act-of-1773
Midafternoon repast	http://www.crosswordgiant.com/crossword-clue/211212/Midafternoon-repast
Product once harbored in Boston?	http://www.crosswordgiant.com/crossword-clue/215504/Product-once-harbored-in-Boston
Assam product	http://www.crosswordgiant.com/crossword-clue/217949/Assam-product
Samovar serving	http://www.crosswordgiant.com/crossword-clue/218212/Samovar-serving
Good source of antioxidants	http://www.crosswordgiant.com/crossword-clue/228500/Good-source-of-antioxidants
1773 castoff	http://www.crosswordgiant.com/crossword-clue/228684/1773-castoff
Crumpet companion	http://www.crosswordgiant.com/crossword-clue/230814/Crumpet-companion
Caffeine provider	http://www.crosswordgiant.com/crossword-clue/232309/Caffeine-provider
Green brew	http://www.crosswordgiant.com/crossword-clue/233980/Green-brew
Start with spoons and cups?	http://www.crosswordgiant.com/crossword-clue/236735/Start-with-spoons-and-cups
Leaves for a drink from a bag?	http://www.crosswordgiant.com/crossword-clue/240919/Leaves-for-a-drink-from-a-bag
Beverage choice	http://www.crosswordgiant.com/crossword-clue/247412/Beverage-choice
Colonists' castoff	http://www.crosswordgiant.com/crossword-clue/253621/Colonists-castoff
It may be served with crumpets	http://www.crosswordgiant.com/crossword-clue/256784/It-may-be-served-with-crumpets
Word with bag or cup	http://www.crosswordgiant.com/crossword-clue/257171/Word-with-bag-or-cup
It may be green or black	http://www.crosswordgiant.com/crossword-clue/257246/It-may-be-green-or-black
Crumpet eater's quaff	http://www.crosswordgiant.com/crossword-clue/259387/Crumpet-eaters-quaff
Healthful drink	http://www.crosswordgiant.com/crossword-clue/265466/Healthful-drink
It may be herbal	http://www.crosswordgiant.com/crossword-clue/266905/It-may-be-herbal
Break in England	http://www.crosswordgiant.com/crossword-clue/276715/Break-in-England
After-dinner serving	http://www.crosswordgiant.com/crossword-clue/285752/After-dinner-serving
Word with cake or party	http://www.crosswordgiant.com/crossword-clue/286690/Word-with-cake-or-party
Leaves for a break?	http://www.crosswordgiant.com/crossword-clue/289737/Leaves-for-a-break
Drink with one lump or two	http://www.crosswordgiant.com/crossword-clue/290062/Drink-with-one-lump-or-two
Caddy contents	http://www.crosswordgiant.com/crossword-clue/292944/Caddy-contents
Leaves for the diner	http://www.crosswordgiant.com/crossword-clue/293776/Leaves-for-the-diner
What's brewing, perhaps	http://www.crosswordgiant.com/crossword-clue/295155/Whats-brewing-perhaps
Chai, e.g.	http://www.crosswordgiant.com/crossword-clue/297295/Chai-e.g
Oolong, e.g.	http://www.crosswordgiant.com/crossword-clue/298759/Oolong-e.g
British time	http://www.crosswordgiant.com/crossword-clue/302693/British-time
English breakfast, e.g.	http://www.crosswordgiant.com/crossword-clue/304438/English-breakfast-e.g
It's bagged in the supermarket, often	http://www.crosswordgiant.com/crossword-clue/305372/Its-bagged-in-the-supermarket-often
English break	http://www.crosswordgiant.com/crossword-clue/306558/English-break
Scone accompaniment	http://www.crosswordgiant.com/crossword-clue/329933/Scone-accompaniment
Scone's go-with	http://www.crosswordgiant.com/crossword-clue/331054/Scones-go-with
Word with spoon or cup	http://www.crosswordgiant.com/crossword-clue/335550/Word-with-spoon-or-cup
Society event	http://www.crosswordgiant.com/crossword-clue/336606/Society-event
Brighton brew	http://www.crosswordgiant.com/crossword-clue/338993/Brighton-brew
Time in London?	http://www.crosswordgiant.com/crossword-clue/339964/Time-in-London
Souchong, e.g.	http://www.crosswordgiant.com/crossword-clue/342400/Souchong-e.g
Kind of cart	http://www.crosswordgiant.com/crossword-clue/363832/Kind-of-cart
Boston Harbor jetsam	http://www.crosswordgiant.com/crossword-clue/364886/Boston-Harbor-jetsam
Twinings offering	http://www.crosswordgiant.com/crossword-clue/372930/Twinings-offering
Cozy intro?	http://www.crosswordgiant.com/crossword-clue/377419/Cozy-intro
Chamomile, e.g.	http://www.crosswordgiant.com/crossword-clue/379464/Chamomile-e.g
Tazo, e.g.	http://www.crosswordgiant.com/crossword-clue/380052/Tazo-e.g
Sipped drink	http://www.crosswordgiant.com/crossword-clue/381223/Sipped-drink
Pot leaves	http://www.crosswordgiant.com/crossword-clue/382761/Pot-leaves
British beverage	http://www.crosswordgiant.com/crossword-clue/385672/British-beverage
Drink served hot or cold	http://www.crosswordgiant.com/crossword-clue/386130/Drink-served-hot-or-cold
Kind of bag or ball	http://www.crosswordgiant.com/crossword-clue/390499/Kind-of-bag-or-ball
Actress Leoni	http://www.crosswordgiant.com/crossword-clue/390729/Actress-Leoni
It was once harbored in Boston	http://www.crosswordgiant.com/crossword-clue/392031/It-was-once-harbored-in-Boston
Winter warmer upper	http://www.crosswordgiant.com/crossword-clue/392084/Winter-warmer-upper
Mad Hatter's affair	http://www.crosswordgiant.com/crossword-clue/392224/Mad-Hatters-affair
Between-meals reception	http://www.crosswordgiant.com/crossword-clue/393283/Between-meals-reception
With 45-Down, beverage dispenser	http://www.crosswordgiant.com/crossword-clue/398997/With-45-Down-beverage-dispenser
Texas ___ (oil)	http://www.crosswordgiant.com/crossword-clue/409444/Texas-___-oil
Beverage for a genteel affair, e.g.	http://www.crosswordgiant.com/crossword-clue/411018/Beverage-for-a-genteel-affair-e.g
Something overthrown shortly before the American Revolution	http://www.crosswordgiant.com/crossword-clue/414807/Something-overthrown-shortly-before-the-American-Revolution
Popular brew	http://www.crosswordgiant.com/crossword-clue/419857/Popular-brew
Potable	http://www.crosswordgiant.com/crossword-clue/421432/Potable
World's most popular drink	http://www.crosswordgiant.com/crossword-clue/422789/Worlds-most-popular-drink
Yunnan or Keemun, e.g.	http://www.crosswordgiant.com/crossword-clue/424423/Yunnan-or-Keemun-e.g
Word that can precede the start of 17- and 59-Across and 11- and 25-Down	http://www.crosswordgiant.com/crossword-clue/433455/Word-that-can-precede-the-start-of-17-and-59-Across-and-11-and-25-Down
Black __	http://www.crosswordgiant.com/crossword-clue/433990/Black-__
Red Zinger, for one	http://www.crosswordgiant.com/crossword-clue/434384/Red-Zinger-for-one
Crumpets' colleague	http://www.crosswordgiant.com/crossword-clue/435206/Crumpets-colleague
Leaves for a drink?	http://www.crosswordgiant.com/crossword-clue/437423/Leaves-for-a-drink
Brewer's product	http://www.crosswordgiant.com/crossword-clue/438183/Brewers-product
With 53-Down, ingredient in some soaps	http://www.crosswordgiant.com/crossword-clue/441879/With-53-Down-ingredient-in-some-soaps
Herb __	http://www.crosswordgiant.com/crossword-clue/443534/Herb-__
Leaves at 4?	http://www.crosswordgiant.com/crossword-clue/444150/Leaves-at-4
Lipton's line	http://www.crosswordgiant.com/crossword-clue/449376/Liptons-line
It's measured in spots?	http://www.crosswordgiant.com/crossword-clue/451269/Its-measured-in-spots
Mint __	http://www.crosswordgiant.com/crossword-clue/451521/Mint-__
Green or black	http://www.crosswordgiant.com/crossword-clue/452795/Green-or-black
Pekoe	http://www.crosswordgiant.com/crossword-clue/456059/Pekoe
Ubiquitous beverage	http://www.crosswordgiant.com/crossword-clue/458059/Ubiquitous-beverage
Indian export	http://www.crosswordgiant.com/crossword-clue/463145/Indian-export
Steeped drink	http://www.crosswordgiant.com/crossword-clue/463352/Steeped-drink
Pekoe purchase	http://www.crosswordgiant.com/crossword-clue/468037/Pekoe-purchase
Alternative to 56-Across	http://www.crosswordgiant.com/crossword-clue/470833/Alternative-to-56-Across
Jetsam in 1773	http://www.crosswordgiant.com/crossword-clue/474000/Jetsam-in-1773
Cozy do	http://www.crosswordgiant.com/crossword-clue/479683/Cozy-do
____ For Two	http://www.crosswordgiant.com/crossword-clue/480412/____-For-Two
Herbal __	http://www.crosswordgiant.com/crossword-clue/486491/Herbal-__
Universal beverage	http://www.crosswordgiant.com/crossword-clue/487987/Universal-beverage
4:00 affair	http://www.crosswordgiant.com/crossword-clue/488036/400-affair
4:00 get-together, in London	http://www.crosswordgiant.com/crossword-clue/491018/400-get-together-in-London
Herbal concoction	http://www.crosswordgiant.com/crossword-clue/491271/Herbal-concoction
English Breakfast or Orange Pekoe	http://www.crosswordgiant.com/crossword-clue/492589/English-Breakfast-or-Orange-Pekoe
58-across, thru the Chunnel	http://www.crosswordgiant.com/crossword-clue/493191/58-across-thru-the-Chunnel
Stuff in a ball	http://www.crosswordgiant.com/crossword-clue/493698/Stuff-in-a-ball
Mad Hatter's serving	http://www.crosswordgiant.com/crossword-clue/494082/Mad-Hatters-serving
Rooibos, for one	http://www.crosswordgiant.com/crossword-clue/498263/Rooibos-for-one
Mad Hatter's beverage	http://www.crosswordgiant.com/crossword-clue/501487/Mad-Hatters-beverage
It may require a cart and a caddy	http://www.crosswordgiant.com/crossword-clue/502276/It-may-require-a-cart-and-a-caddy
It may come in spots	http://www.crosswordgiant.com/crossword-clue/505604/It-may-come-in-spots
Famous party	http://www.crosswordgiant.com/crossword-clue/507077/Famous-party
Leaves for a drink?	http://www.crosswordgiant.com/crossword-clue/508465/Leaves-for-a-drink
Scone go-with	http://www.crosswordgiant.com/crossword-clue/513335/Scone-go-with
Drink in England	http://www.crosswordgiant.com/crossword-clue/515261/Drink-in-England
Dorset drink	http://www.crosswordgiant.com/crossword-clue/517701/Dorset-drink
March Hare's offering	http://www.crosswordgiant.com/crossword-clue/518659/March-Hares-offering
Blackpool break	http://www.crosswordgiant.com/crossword-clue/520669/Blackpool-break
__ set	http://www.crosswordgiant.com/crossword-clue/524403/__-set
Hot  drink	http://www.crosswordgiant.com/crossword-clue/525378/Hot-drink
British East India Company product	http://www.crosswordgiant.com/crossword-clue/526312/British-East-India-Company-product
Djarling or Pekoe	http://www.crosswordgiant.com/crossword-clue/527042/Djarling-or-Pekoe
One way to take opium	http://www.crosswordgiant.com/crossword-clue/527549/One-way-to-take-opium
Starbucks serves it	http://www.crosswordgiant.com/crossword-clue/530628/Starbucks-serves-it
New York's Russian ___ Room	http://www.crosswordgiant.com/crossword-clue/531894/New-Yorks-Russian-___-Room
Caffeinated drink	http://www.crosswordgiant.com/crossword-clue/532479/Caffeinated-drink
Bag of leaves?	http://www.crosswordgiant.com/crossword-clue/538637/Bag-of-leaves
Afternoon delight?	http://www.crosswordgiant.com/crossword-clue/548911/Afternoon-delight
Word with ball or party	http://www.crosswordgiant.com/crossword-clue/551366/Word-with-ball-or-party
Word with ball or caddy	http://www.crosswordgiant.com/crossword-clue/553228/Word-with-ball-or-caddy
____ as it should be!	http://www.crosswordgiant.com/crossword-clue/554067/____-as-it-should-be
Sri Lankan crop	http://www.crosswordgiant.com/crossword-clue/560162/Sri-Lankan-crop
4 p.m., in Kent	http://www.crosswordgiant.com/crossword-clue/561561/4-p.m.-in-Kent
It's steeped in tradition	http://www.crosswordgiant.com/crossword-clue/563141/Its-steeped-in-tradition
Historic Boston Harbor flotsam	http://www.crosswordgiant.com/crossword-clue/569743/Historic-Boston-Harbor-flotsam
It can be for two or for the Tillerman	http://www.crosswordgiant.com/crossword-clue/571864/It-can-be-for-two-or-for-the-Tillerman
Texas __: petroleum	http://www.crosswordgiant.com/crossword-clue/572392/Texas-__-petroleum
Major export from 45-Down	http://www.crosswordgiant.com/crossword-clue/582118/Major-export-from-45-Down
Pekoe or Djarling	http://www.crosswordgiant.com/crossword-clue/585577/Pekoe-or-Djarling
Hot beverage	http://www.crosswordgiant.com/crossword-clue/587941/Hot-beverage
''High'' beverage	http://www.crosswordgiant.com/crossword-clue/588896/High-beverage
Bag of leaves, perhaps	http://www.crosswordgiant.com/crossword-clue/592761/Bag-of-leaves-perhaps
Kettle contents	http://www.crosswordgiant.com/crossword-clue/595552/Kettle-contents
Surrey sip	http://www.crosswordgiant.com/crossword-clue/599041/Surrey-sip
4:00 drink	http://www.crosswordgiant.com/crossword-clue/602177/400-drink
1773 Boston Harbor jetsam	http://www.crosswordgiant.com/crossword-clue/605551/1773-Boston-Harbor-jetsam
What's in the bag?	http://www.crosswordgiant.com/crossword-clue/611781/Whats-in-the-bag
It may be taken in the afternoon	http://www.crosswordgiant.com/crossword-clue/613312/It-may-be-taken-in-the-afternoon
Spot from a pot?	http://www.crosswordgiant.com/crossword-clue/616575/Spot-from-a-pot
It's bagged in the grocery store	http://www.crosswordgiant.com/crossword-clue/620215/Its-bagged-in-the-grocery-store
Word after beef or cream	http://www.crosswordgiant.com/crossword-clue/622420/Word-after-beef-or-cream
Focus of a 1773 party	http://www.crosswordgiant.com/crossword-clue/624466/Focus-of-a-1773-party
Four p.m. affair	http://www.crosswordgiant.com/crossword-clue/627927/Four-p.m.-affair
Stash offering	http://www.crosswordgiant.com/crossword-clue/628229/Stash-offering
Word with ''bag'' or ''caddy''	http://www.crosswordgiant.com/crossword-clue/635896/Word-with-bag-or-caddy
Mad Hatter affair	http://www.crosswordgiant.com/crossword-clue/639010/Mad-Hatter-affair
Leaves in a vessel	http://www.crosswordgiant.com/crossword-clue/639271/Leaves-in-a-vessel
Earl Grey or Darjeeling	http://www.crosswordgiant.com/crossword-clue/644069/Earl-Grey-or-Darjeeling
Drink with a scone	http://www.crosswordgiant.com/crossword-clue/645310/Drink-with-a-scone
Chamomile, for one	http://www.crosswordgiant.com/crossword-clue/649492/Chamomile-for-one
It was once harbored in Boston?	http://www.crosswordgiant.com/crossword-clue/649970/It-was-once-harbored-in-Boston
Drink in the afternoon	http://www.crosswordgiant.com/crossword-clue/650665/Drink-in-the-afternoon
Celestial Seasonings offering	http://www.crosswordgiant.com/crossword-clue/652194/Celestial-Seasonings-offering
Word after green or gunpowder	http://www.crosswordgiant.com/crossword-clue/660167/Word-after-green-or-gunpowder
Leaves from China, often	http://www.crosswordgiant.com/crossword-clue/668967/Leaves-from-China-often
Caffeinated beverage	http://www.crosswordgiant.com/crossword-clue/669479/Caffeinated-beverage
Leaves in the pot?	http://www.crosswordgiant.com/crossword-clue/670802/Leaves-in-the-pot
With 49-Down, "Spanglish" actress	http://www.crosswordgiant.com/crossword-clue/673489/With-49-Down-Spanglish-actress
With 76D, "Spanglish" star	http://www.crosswordgiant.com/crossword-clue/674299/With-76D-Spanglish-star
Chanoyu drink	http://www.crosswordgiant.com/crossword-clue/675044/Chanoyu-drink
Mad Hatter's serving	http://www.crosswordgiant.com/crossword-clue/679613/Mad-Hatters-serving
Wonderland spot	http://www.crosswordgiant.com/crossword-clue/681387/Wonderland-spot
Pekoe or green	http://www.crosswordgiant.com/crossword-clue/682074/Pekoe-or-green
Hunan or dynamite	http://www.crosswordgiant.com/crossword-clue/682613/Hunan-or-dynamite
Mad Hatter's drink	http://www.crosswordgiant.com/crossword-clue/684128/Mad-Hatters-drink
It may be bagged	http://www.crosswordgiant.com/crossword-clue/685122/It-may-be-bagged
Afternoon drink, for many	http://www.crosswordgiant.com/crossword-clue/697082/Afternoon-drink-for-many
Event at which some people wear gloves	http://www.crosswordgiant.com/crossword-clue/698066/Event-at-which-some-people-wear-gloves
'___ With Mussolini' (Zeffirelli film)	http://www.crosswordgiant.com/crossword-clue/703810/___-With-Mussolini-Zeffirelli-film
Cup with crumpets	http://www.crosswordgiant.com/crossword-clue/707404/Cup-with-crumpets
Pinky-out drink	http://www.crosswordgiant.com/crossword-clue/707477/Pinky-out-drink
Something steeped	http://www.crosswordgiant.com/crossword-clue/708607/Something-steeped
Social beverage	http://www.crosswordgiant.com/crossword-clue/713029/Social-beverage
Bigelow offering	http://www.crosswordgiant.com/crossword-clue/715926/Bigelow-offering
What some caddies carry	http://www.crosswordgiant.com/crossword-clue/717329/What-some-caddies-carry
Leaves with dessert?	http://www.crosswordgiant.com/crossword-clue/717979/Leaves-with-dessert
49-Across product	http://www.crosswordgiant.com/crossword-clue/721900/49-Across-product
"___ with Mussolini" (1999 film)	http://www.crosswordgiant.com/crossword-clue/722596/___-with-Mussolini-1999-film
What the Hatter and the March Hare drank	http://www.crosswordgiant.com/crossword-clue/730601/What-the-Hatter-and-the-March-Hare-drank
Afternoon ritual	http://www.crosswordgiant.com/crossword-clue/730668/Afternoon-ritual
It's taken in spots	http://www.crosswordgiant.com/crossword-clue/731969/Its-taken-in-spots
Jasmine or Monk's Blend	http://www.crosswordgiant.com/crossword-clue/734949/Jasmine-or-Monks-Blend
Samovar beverage	http://www.crosswordgiant.com/crossword-clue/738581/Samovar-beverage
Social gathering	http://www.crosswordgiant.com/crossword-clue/741288/Social-gathering
What the Mad Hatter served	http://www.crosswordgiant.com/crossword-clue/743038/What-the-Mad-Hatter-served
Afternoon nosh	http://www.crosswordgiant.com/crossword-clue/743798/Afternoon-nosh
Soho social	http://www.crosswordgiant.com/crossword-clue/744299/Soho-social
Leaves held in the bag	http://www.crosswordgiant.com/crossword-clue/745316/Leaves-held-in-the-bag
__ service	http://www.crosswordgiant.com/crossword-clue/747496/__-service
Lipton option	http://www.crosswordgiant.com/crossword-clue/747963/Lipton-option
Chief crop of 1-Across	http://www.crosswordgiant.com/crossword-clue/753200/Chief-crop-of-1-Across
Bagged leaves?	http://www.crosswordgiant.com/crossword-clue/755161/Bagged-leaves
Submerged leaves	http://www.crosswordgiant.com/crossword-clue/757116/Submerged-leaves
It may be iced	http://www.crosswordgiant.com/crossword-clue/760180/It-may-be-iced
Bagged beverage	http://www.crosswordgiant.com/crossword-clue/761876/Bagged-beverage
Herbal preparation	http://www.crosswordgiant.com/crossword-clue/763429/Herbal-preparation
Black or green stuff	http://www.crosswordgiant.com/crossword-clue/765371/Black-or-green-stuff
Mad Hatter's serving	http://www.crosswordgiant.com/crossword-clue/766938/Mad-Hatters-serving
Spot from a pot	http://www.crosswordgiant.com/crossword-clue/770844/Spot-from-a-pot
Mid-afternoon drink	http://www.crosswordgiant.com/crossword-clue/772326/Mid-afternoon-drink
Cozy drink?	http://www.crosswordgiant.com/crossword-clue/773770/Cozy-drink
A&P's original business	http://www.crosswordgiant.com/crossword-clue/777695/APs-original-business
Hyson or oolong	http://www.crosswordgiant.com/crossword-clue/778227/Hyson-or-oolong
Dainty beverage	http://www.crosswordgiant.com/crossword-clue/778526/Dainty-beverage
__ party	http://www.crosswordgiant.com/crossword-clue/780677/__-party
March Hare's offering	http://www.crosswordgiant.com/crossword-clue/782019/March-Hares-offering
Something bagged in the pantry	http://www.crosswordgiant.com/crossword-clue/785683/Something-bagged-in-the-pantry
It can be black or green	http://www.crosswordgiant.com/crossword-clue/789791/It-can-be-black-or-green
Pekoe,for one	http://www.crosswordgiant.com/crossword-clue/792853/Pekoefor-one
Beverage served hot or cold	http://www.crosswordgiant.com/crossword-clue/794635/Beverage-served-hot-or-cold
Darjeeling drink	http://www.crosswordgiant.com/crossword-clue/795624/Darjeeling-drink
4:00 London social	http://www.crosswordgiant.com/crossword-clue/798570/400-London-social
White-glove affair	http://www.crosswordgiant.com/crossword-clue/799290/White-glove-affair
Kettle filler	http://www.crosswordgiant.com/crossword-clue/804060/Kettle-filler
Crumpets' partner	http://www.crosswordgiant.com/crossword-clue/804975/Crumpets-partner
Drink with a string in it, perhaps	http://www.crosswordgiant.com/crossword-clue/806723/Drink-with-a-string-in-it-perhaps
Drink with its own character in the Chinese alphabet	http://www.crosswordgiant.com/crossword-clue/808585/Drink-with-its-own-character-in-the-Chinese-alphabet
Beverage with scones	http://www.crosswordgiant.com/crossword-clue/816458/Beverage-with-scones
__ leaf	http://www.crosswordgiant.com/crossword-clue/816472/__-leaf
See 49 Down	http://www.crosswordgiant.com/crossword-clue/817451/See-49-Down
What the Mad Hatter pours on the Dormouse to wake it up	http://www.crosswordgiant.com/crossword-clue/820393/What-the-Mad-Hatter-pours-on-the-Dormouse-to-wake-it-up
Orange pekoe, e.g.	http://www.crosswordgiant.com/crossword-clue/822763/Orange-pekoe-e.g
4 p.m. drink	http://www.crosswordgiant.com/crossword-clue/825001/4-p.m.-drink
___ Party movement	http://www.crosswordgiant.com/crossword-clue/827479/___-Party-movement
Wonderland beverage	http://www.crosswordgiant.com/crossword-clue/832222/Wonderland-beverage
''Iced'' drink	http://www.crosswordgiant.com/crossword-clue/833630/Iced-drink
Afternoon meal, across the pond	http://www.crosswordgiant.com/crossword-clue/834793/Afternoon-meal-across-the-pond
Breakfast cupful	http://www.crosswordgiant.com/crossword-clue/837650/Breakfast-cupful
Crumpet's go-with	http://www.crosswordgiant.com/crossword-clue/842586/Crumpets-go-with
It's bagged at the market	http://www.crosswordgiant.com/crossword-clue/851017/Its-bagged-at-the-market
Drink in a pot	http://www.crosswordgiant.com/crossword-clue/854636/Drink-in-a-pot
Drink served in ''spots''	http://www.crosswordgiant.com/crossword-clue/855732/Drink-served-in-spots
Bag contents, often	http://www.crosswordgiant.com/crossword-clue/856772/Bag-contents-often
Crumpet accompaniment	http://www.crosswordgiant.com/crossword-clue/859489/Crumpet-accompaniment
Beverage with crumpets	http://www.crosswordgiant.com/crossword-clue/860275/Beverage-with-crumpets
It may be sun-brewed	http://www.crosswordgiant.com/crossword-clue/860436/It-may-be-sun-brewed
Reefer, in slang	http://www.crosswordgiant.com/crossword-clue/860472/Reefer-in-slang
Afternoon drink, for some	http://www.crosswordgiant.com/crossword-clue/862838/Afternoon-drink-for-some
Oolong or darjeeling	http://www.crosswordgiant.com/crossword-clue/864538/Oolong-or-darjeeling
Something to take in the afternoon	http://www.crosswordgiant.com/crossword-clue/865369/Something-to-take-in-the-afternoon
Coventry cupful	http://www.crosswordgiant.com/crossword-clue/867388/Coventry-cupful
Kind of party for Glenn Beck?	http://www.crosswordgiant.com/crossword-clue/873339/Kind-of-party-for-Glenn-Beck
Camellia sinensis product	http://www.crosswordgiant.com/crossword-clue/874179/Camellia-sinensis-product
Type of leaf or service	http://www.crosswordgiant.com/crossword-clue/881223/Type-of-leaf-or-service
Small bag of buds that might chill you out	http://www.crosswordgiant.com/crossword-clue/889656/Small-bag-of-buds-that-might-chill-you-out
It may be taken in a parlor	http://www.crosswordgiant.com/crossword-clue/890319/It-may-be-taken-in-a-parlor
Healthful quaff	http://www.crosswordgiant.com/crossword-clue/892004/Healthful-quaff
Beverage often served with lemon	http://www.crosswordgiant.com/crossword-clue/892665/Beverage-often-served-with-lemon
Kiwi's mealtime	http://www.crosswordgiant.com/crossword-clue/894055/Kiwis-mealtime
Red Rose beverage	http://www.crosswordgiant.com/crossword-clue/895588/Red-Rose-beverage
Green or black brew	http://www.crosswordgiant.com/crossword-clue/896306/Green-or-black-brew
British East India Co. monopoly	http://www.crosswordgiant.com/crossword-clue/901588/British-East-India-Co.-monopoly
Robert Andersons ___ and Sympathy	http://www.crosswordgiant.com/crossword-clue/906624/Robert-Andersons-___-and-Sympathy
Word with "service" or "ceremony"	http://www.crosswordgiant.com/crossword-clue/906937/Word-with-service-or-ceremony
Oolong or Earl Grey	http://www.crosswordgiant.com/crossword-clue/911473/Oolong-or-Earl-Grey
Earl or Lady Grey	http://www.crosswordgiant.com/crossword-clue/911667/Earl-or-Lady-Grey
__ bag	http://www.crosswordgiant.com/crossword-clue/912105/__-bag
Sri Lanka crop	http://www.crosswordgiant.com/crossword-clue/913730/Sri-Lanka-crop
Drink with a 13 Across	http://www.crosswordgiant.com/crossword-clue/914895/Drink-with-a-13-Across
Bag content	http://www.crosswordgiant.com/crossword-clue/918351/Bag-content
Word with cozy or bag	http://www.crosswordgiant.com/crossword-clue/922847/Word-with-cozy-or-bag
Party for Palin	http://www.crosswordgiant.com/crossword-clue/923640/Party-for-Palin
4:00 English drink	http://www.crosswordgiant.com/crossword-clue/924823/400-English-drink
Product of the Camellia sinensis plant	http://www.crosswordgiant.com/crossword-clue/927701/Product-of-the-Camellia-sinensis-plant
Pot substance	http://www.crosswordgiant.com/crossword-clue/932858/Pot-substance
Leaves in the afternoon?	http://www.crosswordgiant.com/crossword-clue/933613/Leaves-in-the-afternoon
Drink offered to Alice	http://www.crosswordgiant.com/crossword-clue/935054/Drink-offered-to-Alice
Mad Hatter's brew	http://www.crosswordgiant.com/crossword-clue/936425/Mad-Hatters-brew
Beverage for Wallace and Gromit	http://www.crosswordgiant.com/crossword-clue/937671/Beverage-for-Wallace-and-Gromit
This towel is for drying dishes	http://www.crosswordgiant.com/crossword-clue/959032/This-towel-is-for-drying-dishes
Ate the drink?	http://www.crosswordgiant.com/crossword-clue/967737/Ate-the-drink
Strangely, ate this drink	http://www.crosswordgiant.com/crossword-clue/972943/Strangely-ate-this-drink
Drink made from leaves	http://www.crosswordgiant.com/crossword-clue/974281/Drink-made-from-leaves
Strangely, one may eat this drink	http://www.crosswordgiant.com/crossword-clue/992776/Strangely-one-may-eat-this-drink
Popular beverage brewed at home	http://www.crosswordgiant.com/crossword-clue/993151/Popular-beverage-brewed-at-home
Just a meal - eat up	http://www.crosswordgiant.com/crossword-clue/995257/Just-a-meal-eat-up
A light meal - eat up	http://www.crosswordgiant.com/crossword-clue/999827/A-light-meal-eat-up
Evening meal - eat up	http://www.crosswordgiant.com/crossword-clue/1013830/Evening-meal-eat-up
Afternoon or evening meal	http://www.crosswordgiant.com/crossword-clue/1016465/Afternoon-or-evening-meal
Light meal - eat up	http://www.crosswordgiant.com/crossword-clue/1019808/Light-meal-eat-up
The cup that cheers but not inebriates	http://www.crosswordgiant.com/crossword-clue/1028980/The-cup-that-cheers-but-not-inebriates
42 followers, by the sound of it	http://www.crosswordgiant.com/crossword-clue/1044115/42-followers-by-the-sound-of-it
One might pour this over you, by the sound of it	http://www.crosswordgiant.com/crossword-clue/1049338/One-might-pour-this-over-you-by-the-sound-of-it
Sing afterwards, just so as to annoy	http://www.crosswordgiant.com/crossword-clue/1050794/Sing-afterwards-just-so-as-to-annoy
This ring is a rip	http://www.crosswordgiant.com/crossword-clue/1056379/This-ring-is-a-rip
15 across is what to do with this before you	http://www.crosswordgiant.com/crossword-clue/1056655/15-across-is-what-to-do-with-this-before-you
The sort of ring that's absolutely ripping	http://www.crosswordgiant.com/crossword-clue/1060021/The-sort-of-ring-thats-absolutely-ripping
The sort of ring that's a rip in the cup	http://www.crosswordgiant.com/crossword-clue/1063203/The-sort-of-ring-thats-a-rip-in-the-cup
One might give this a ring and let it rip	http://www.crosswordgiant.com/crossword-clue/1064727/One-might-give-this-a-ring-and-let-it-rip
That might get the cup before you	http://www.crosswordgiant.com/crossword-clue/1066124/That-might-get-the-cup-before-you
You follow such ring for a rip	http://www.crosswordgiant.com/crossword-clue/1066328/You-follow-such-ring-for-a-rip
A rip might have this sort of ring	http://www.crosswordgiant.com/crossword-clue/1066762/A-rip-might-have-this-sort-of-ring
One gets drunk before you	http://www.crosswordgiant.com/crossword-clue/1066962/One-gets-drunk-before-you
Not after you, before you	http://www.crosswordgiant.com/crossword-clue/1068502/Not-after-you-before-you
You follow this for a meal?	http://www.crosswordgiant.com/crossword-clue/1069785/You-follow-this-for-a-meal
This ring for a rip	http://www.crosswordgiant.com/crossword-clue/1072504/This-ring-for-a-rip
Sounds as if you might be a follower of this	http://www.crosswordgiant.com/crossword-clue/1073773/Sounds-as-if-you-might-be-a-follower-of-this
That sort of ring is a rip	http://www.crosswordgiant.com/crossword-clue/1077039/That-sort-of-ring-is-a-rip
You might have this drink before you	http://www.crosswordgiant.com/crossword-clue/1078134/You-might-have-this-drink-before-you
After the gala, a drink will make her lively	http://www.crosswordgiant.com/crossword-clue/1078938/After-the-gala-a-drink-will-make-her-lively
A drink that made 31 across come to life	http://www.crosswordgiant.com/crossword-clue/1082704/A-drink-that-made-31-across-come-to-life
May be poured before you	http://www.crosswordgiant.com/crossword-clue/1083205/May-be-poured-before-you
Perhaps it's potted	http://www.crosswordgiant.com/crossword-clue/1083805/Perhaps-its-potted
This could get a ring for a rip	http://www.crosswordgiant.com/crossword-clue/1089495/This-could-get-a-ring-for-a-rip
How ripping it could be to have such a drink with a ring!	http://www.crosswordgiant.com/crossword-clue/1092548/How-ripping-it-could-be-to-have-such-a-drink-with-a-ring
Aged enough to be up for the cup	http://www.crosswordgiant.com/crossword-clue/1093877/Aged-enough-to-be-up-for-the-cup
You sound like a follower of this	http://www.crosswordgiant.com/crossword-clue/1097093/You-sound-like-a-follower-of-this
You might sound like this after a drink like this	http://www.crosswordgiant.com/crossword-clue/1101385/You-might-sound-like-this-after-a-drink-like-this
42 afterwards, by the sound of it	http://www.crosswordgiant.com/crossword-clue/1103982/42-afterwards-by-the-sound-of-it
Sounds as if you follow the pouring of this	http://www.crosswordgiant.com/crossword-clue/1107523/Sounds-as-if-you-follow-the-pouring-of-this
-42?	http://www.crosswordgiant.com/crossword-clue/1112077/-42
Before you get a ring for a rent	http://www.crosswordgiant.com/crossword-clue/1116526/Before-you-get-a-ring-for-a-rent
Sounds as if the drink comes before you	http://www.crosswordgiant.com/crossword-clue/1122327/Sounds-as-if-the-drink-comes-before-you
Just before you, by the sound of it	http://www.crosswordgiant.com/crossword-clue/1123110/Just-before-you-by-the-sound-of-it
You follow this for a cup	http://www.crosswordgiant.com/crossword-clue/1126098/You-follow-this-for-a-cup
You follow it for a drink	http://www.crosswordgiant.com/crossword-clue/1130789/You-follow-it-for-a-drink
2 4 this	http://www.crosswordgiant.com/crossword-clue/1131382/2-4-this
There's a drink before you	http://www.crosswordgiant.com/crossword-clue/1135582/Theres-a-drink-before-you
This 42?	http://www.crosswordgiant.com/crossword-clue/1136566/This-42
Sing after this just to be a nuisance	http://www.crosswordgiant.com/crossword-clue/1139495/Sing-after-this-just-to-be-a-nuisance
After this you come for a cup	http://www.crosswordgiant.com/crossword-clue/1141061/After-this-you-come-for-a-cup
42 following this?	http://www.crosswordgiant.com/crossword-clue/1141228/42-following-this
What you afterwards poured	http://www.crosswordgiant.com/crossword-clue/1143673/What-you-afterwards-poured
Gets poured before you	http://www.crosswordgiant.com/crossword-clue/1143862/Gets-poured-before-you
The sort of drink that can be absolutely ripping with a ring	http://www.crosswordgiant.com/crossword-clue/1145721/The-sort-of-drink-that-can-be-absolutely-ripping-with-a-ring
You follow it, by the sound of it	http://www.crosswordgiant.com/crossword-clue/1145917/You-follow-it-by-the-sound-of-it
Put it before you?	http://www.crosswordgiant.com/crossword-clue/1147082/Put-it-before-you
Not after you - just drunk	http://www.crosswordgiant.com/crossword-clue/1149805/Not-after-you-just-drunk
Four two after this at four	http://www.crosswordgiant.com/crossword-clue/1150491/Four-two-after-this-at-four
Before you for the after noon?	http://www.crosswordgiant.com/crossword-clue/1150673/Before-you-for-the-after-noon
This ring is simply ripping	http://www.crosswordgiant.com/crossword-clue/1151550/This-ring-is-simply-ripping
Poured before you, by the sound of it	http://www.crosswordgiant.com/crossword-clue/1152104/Poured-before-you-by-the-sound-of-it
Pour out the start of 21 across before you, by the sound of it	http://www.crosswordgiant.com/crossword-clue/1153208/Pour-out-the-start-of-21-across-before-you-by-the-sound-of-it
You sound like a follower of this in a cup	http://www.crosswordgiant.com/crossword-clue/1154666/You-sound-like-a-follower-of-this-in-a-cup
By the sound of it, it's before you to brew (3)	http://www.crosswordgiant.com/crossword-clue/1156026/By-the-sound-of-it-its-before-you-to-brew-3
Sounds as if you follow a soft drink	http://www.crosswordgiant.com/crossword-clue/1159423/Sounds-as-if-you-follow-a-soft-drink
All that the driver can drink, of course	http://www.crosswordgiant.com/crossword-clue/1160579/All-that-the-driver-can-drink-of-course
Leaves before you, by the sound of it	http://www.crosswordgiant.com/crossword-clue/1160977/Leaves-before-you-by-the-sound-of-it
Just one drink before you, by the sound of it	http://www.crosswordgiant.com/crossword-clue/1164331/Just-one-drink-before-you-by-the-sound-of-it
Sound before you	http://www.crosswordgiant.com/crossword-clue/1168310/Sound-before-you
42?	http://www.crosswordgiant.com/crossword-clue/1170864/42
'Before you, in short, and before 1 across (3)'	http://www.crosswordgiant.com/crossword-clue/1173425/Before-you-in-short-and-before-1-across-3
Green or sassafras	http://www.crosswordgiant.com/crossword-clue/1191249/Green-or-sassafras
Four O'Clock is a brand of it	http://www.crosswordgiant.com/crossword-clue/1199101/Four-OClock-is-a-brand-of-it
"When I Take My Sugar to __": 1931 hit	http://www.crosswordgiant.com/crossword-clue/1203088/When-I-Take-My-Sugar-to-__-1931-hit
Comes before you, by the sound of it	http://www.crosswordgiant.com/crossword-clue/1206823/Comes-before-you-by-the-sound-of-it
Brit brew	http://www.crosswordgiant.com/crossword-clue/1208651/Brit-brew
Afternoon cup	http://www.crosswordgiant.com/crossword-clue/1215970/Afternoon-cup
Something sipped with a scone	http://www.crosswordgiant.com/crossword-clue/1223746/Something-sipped-with-a-scone
Drink this and listen to the letter before you I say	http://www.crosswordgiant.com/crossword-clue/1224197/Drink-this-and-listen-to-the-letter-before-you-I-say
Pekoe, e.g	http://www.crosswordgiant.com/crossword-clue/1230350/Pekoe-e.g
4 o'clock refreshment	http://www.crosswordgiant.com/crossword-clue/1253880/4-oclock-refreshment
Type of service or caddy	http://www.crosswordgiant.com/crossword-clue/1255420/Type-of-service-or-caddy
Drink a drop shortly	http://www.crosswordgiant.com/crossword-clue/1301784/Drink-a-drop-shortly
From which one drives, say, for a drink	http://www.crosswordgiant.com/crossword-clue/1316812/From-which-one-drives-say-for-a-drink
Non-alcoholic drink is what driver needs, we hear	http://www.crosswordgiant.com/crossword-clue/1323460/Non-alcoholic-drink-is-what-driver-needs-we-hear
Meal - drink	http://www.crosswordgiant.com/crossword-clue/1348873/Meal-drink
Sort of garden, chest or service	http://www.crosswordgiant.com/crossword-clue/1362385/Sort-of-garden-chest-or-service
Cuppa	http://www.crosswordgiant.com/crossword-clue/1362716/Cuppa
Lapsang souchong	http://www.crosswordgiant.com/crossword-clue/1374294/Lapsang-souchong
Leaves for brewing	http://www.crosswordgiant.com/crossword-clue/1395656/Leaves-for-brewing
Kenyan export	http://www.crosswordgiant.com/crossword-clue/1408232/Kenyan-export
Type of spoon or cup	http://www.crosswordgiant.com/crossword-clue/1409516/Type-of-spoon-or-cup
Lapsang souchong, e.g	http://www.crosswordgiant.com/crossword-clue/1415138/Lapsang-souchong-e.g
Leaves producer with party	http://www.crosswordgiant.com/crossword-clue/1415694/Leaves-producer-with-party
Spot in a pot	http://www.crosswordgiant.com/crossword-clue/1423404/Spot-in-a-pot
Drink from Tazo	http://www.crosswordgiant.com/crossword-clue/1423437/Drink-from-Tazo
Drawing room event	http://www.crosswordgiant.com/crossword-clue/1431884/Drawing-room-event
Long Island Iced ___	http://www.crosswordgiant.com/crossword-clue/1435789/Long-Island-Iced-___
Caddy's contents	http://www.crosswordgiant.com/crossword-clue/1437671/Caddys-contents
Small bag of leaves	http://www.crosswordgiant.com/crossword-clue/1443493/Small-bag-of-leaves
Hot brewed beverage	http://www.crosswordgiant.com/crossword-clue/1444483/Hot-brewed-beverage
Party serving	http://www.crosswordgiant.com/crossword-clue/1445646/Party-serving
Export of India	http://www.crosswordgiant.com/crossword-clue/1450886/Export-of-India
4 p.m. refreshment, perhaps	http://www.crosswordgiant.com/crossword-clue/1451211/4-p.m.-refreshment-perhaps
Alternative to 38-Down	http://www.crosswordgiant.com/crossword-clue/1452452/Alternative-to-38-Down
Major Kenyan export	http://www.crosswordgiant.com/crossword-clue/1457283/Major-Kenyan-export
Leoni of 'Tower Heist'	http://www.crosswordgiant.com/crossword-clue/1460248/Leoni-of-Tower-Heist
Tetley drink	http://www.crosswordgiant.com/crossword-clue/1464981/Tetley-drink
Oolong or souchong	http://www.crosswordgiant.com/crossword-clue/1466818/Oolong-or-souchong
With 6-Down, cups and saucers and such	http://www.crosswordgiant.com/crossword-clue/1476729/With-6-Down-cups-and-saucers-and-such
Spot in front of the telly?	http://www.crosswordgiant.com/crossword-clue/1477842/Spot-in-front-of-the-telly
Leaves in cups	http://www.crosswordgiant.com/crossword-clue/1481051/Leaves-in-cups
Twinings drink	http://www.crosswordgiant.com/crossword-clue/1481441/Twinings-drink
Weak ___	http://www.crosswordgiant.com/crossword-clue/1482584/Weak-___
Leaves in the pantry	http://www.crosswordgiant.com/crossword-clue/1483162/Leaves-in-the-pantry
Orange Pekoe or English Breakfast	http://www.crosswordgiant.com/crossword-clue/1495155/Orange-Pekoe-or-English-Breakfast
Subject of a 1773 Act of Parliament	http://www.crosswordgiant.com/crossword-clue/1497881/Subject-of-a-1773-Act-of-Parliament
