Actor Baldwin	crosswordtracker.com/clue/actor-baldwin/
Economist Smith	crosswordtracker.com/clue/economist-smith/
Fall guy	crosswordtracker.com/clue/fall-guy/
Garden man	crosswordtracker.com/clue/garden-man/
First mate?	crosswordtracker.com/clue/first-mate/
"Bonanza" brother	crosswordtracker.com/clue/bonanza-brother/
Sixth-day creation	crosswordtracker.com/clue/sixth-day-creation/
Garden party?	crosswordtracker.com/clue/garden-party/
Genesis name	crosswordtracker.com/clue/genesis-name/
First of all	crosswordtracker.com/clue/first-of-all/
Actor Arkin	crosswordtracker.com/clue/actor-arkin/
Genesis man	crosswordtracker.com/clue/genesis-man/
First lady's mate?	crosswordtracker.com/clue/first-ladys-mate/
"Paradise Lost" character	crosswordtracker.com/clue/paradise-lost-character/
First mate	crosswordtracker.com/clue/first-mate-1/
First family member	crosswordtracker.com/clue/first-family-member-1/
Cain raiser	crosswordtracker.com/clue/cain-raiser/
First of all?	crosswordtracker.com/clue/first-of-all-1/
Furniture style	crosswordtracker.com/clue/furniture-style/
Eden dweller	crosswordtracker.com/clue/eden-dweller/
Leading man?	crosswordtracker.com/clue/leading-man/
Sistine Chapel figure	crosswordtracker.com/clue/sistine-chapel-figure/
Genesis figure	crosswordtracker.com/clue/genesis-figure/
Genesis patriarch	crosswordtracker.com/clue/genesis-patriarch-1/
Fall guy?	crosswordtracker.com/clue/fall-guy-1/
Eden evictee	crosswordtracker.com/clue/eden-evictee/
First man	crosswordtracker.com/clue/first-man/
Rodin sculpture	crosswordtracker.com/clue/rodin-sculpture/
Sistine Chapel depiction	crosswordtracker.com/clue/sistine-chapel-depiction/
Person on the Sistine Chapel ceiling	crosswordtracker.com/clue/person-on-the-sistine-chapel-ceiling/
Sistine Chapel ceiling figure	crosswordtracker.com/clue/sistine-chapel-ceiling-figure/
Eve's mate	crosswordtracker.com/clue/eves-mate/
First-family member	crosswordtracker.com/clue/first-family-member/
One who raised Cain	crosswordtracker.com/clue/one-who-raised-cain/
Garden figure	crosswordtracker.com/clue/garden-figure/
"As You Like It" servant	crosswordtracker.com/clue/as-you-like-it-servant/
Race starter?	crosswordtracker.com/clue/race-starter/
First name?	crosswordtracker.com/clue/first-name/
Eden resident	crosswordtracker.com/clue/eden-resident/
Comic Sandler	crosswordtracker.com/clue/comic-sandler/
Eve's husband	crosswordtracker.com/clue/eves-husband/
Sandler of "Big Daddy"	crosswordtracker.com/clue/sandler-of-big-daddy/
Eliot's Bede	crosswordtracker.com/clue/eliots-bede/
Early exile	crosswordtracker.com/clue/early-exile/
Cain's father	crosswordtracker.com/clue/cains-father/
Garden dweller	crosswordtracker.com/clue/garden-dweller/
Sixth day creation	crosswordtracker.com/clue/sixth-day-creation-1/
Brother of Little Joe	crosswordtracker.com/clue/brother-of-little-joe/
Smith or Sandler	crosswordtracker.com/clue/smith-or-sandler/
Genesis gent	crosswordtracker.com/clue/genesis-gent/
Sandler of "The Longest Yard"	crosswordtracker.com/clue/sandler-of-the-longest-yard-1/
''Bonanza'' brother	crosswordtracker.com/clue/bonanza-brother-1/
Garden evictee	crosswordtracker.com/clue/garden-evictee/
First family member?	crosswordtracker.com/clue/first-family-member-2/
"Bonanza" role	crosswordtracker.com/clue/bonanza-role-1/
Funnyman Sandler	crosswordtracker.com/clue/funnyman-sandler/
Noted bone donor	crosswordtracker.com/clue/noted-bone-donor/
Eve's man	crosswordtracker.com/clue/eves-man/
Role in Haydn's "The Creation"	crosswordtracker.com/clue/role-in-haydns-the-creation/
Bede of fiction	crosswordtracker.com/clue/bede-of-fiction/
Early evictee	crosswordtracker.com/clue/early-evictee/
Original sinner	crosswordtracker.com/clue/original-sinner/
Eden guy	crosswordtracker.com/clue/eden-guy/
Little Joe's brother	crosswordtracker.com/clue/little-joes-brother/
Sandler of "Funny People"	crosswordtracker.com/clue/sandler-of-funny-people/
Abel's father	crosswordtracker.com/clue/abels-father/
Sandler of "You Don't Mess with the Zohan"	crosswordtracker.com/clue/sandler-of-you-dont-mess-with-the-zohan/
Sandler of "The Wedding Singer"	crosswordtracker.com/clue/sandler-of-the-wedding-singer/
''Bonanza'' role	crosswordtracker.com/clue/bonanza-role/
Ant who sings	crosswordtracker.com/clue/ant-who-sings/
Father of Cain and Abel	crosswordtracker.com/clue/father-of-cain-and-abel/
First of billions	crosswordtracker.com/clue/first-of-billions/
Eve's partner	crosswordtracker.com/clue/eves-partner/
"Madam, I'm ___"	crosswordtracker.com/clue/madam-im-___/
Creation on the sixth day	crosswordtracker.com/clue/creation-on-the-sixth-day/
Man who was never born	crosswordtracker.com/clue/man-who-was-never-born/
First person	crosswordtracker.com/clue/first-person-20/
Being No. 1?	crosswordtracker.com/clue/being-no-1/
As old as ___	crosswordtracker.com/clue/as-old-as-___/
"Giselle" composer	crosswordtracker.com/clue/giselle-composer/
Early fruit fancier	crosswordtracker.com/clue/early-fruit-fancier/
Costa loser	crosswordtracker.com/clue/costa-loser/
Early gardener?	crosswordtracker.com/clue/early-gardener/
The #1 guy?	crosswordtracker.com/clue/the-1-guy/
An apple was named after him	crosswordtracker.com/clue/an-apple-was-named-after-him/
Sistine ceiling figure	crosswordtracker.com/clue/sistine-ceiling-figure/
Genesis progenitor	crosswordtracker.com/clue/genesis-progenitor/
First grandfather	crosswordtracker.com/clue/first-grandfather/
Sistine Chapel subject	crosswordtracker.com/clue/sistine-chapel-subject/
"Back to the Batcave" autobiographer West	crosswordtracker.com/clue/back-to-the-batcave-autobiographer-west/
Cain and Abel's dad	crosswordtracker.com/clue/cain-and-abels-dad/
West of Gotham City	crosswordtracker.com/clue/west-of-gotham-city/
Eve's spouse	crosswordtracker.com/clue/eves-spouse/
Actor Sandler	crosswordtracker.com/clue/actor-sandler/
He raised Cain	crosswordtracker.com/clue/he-raised-cain/
Figure in a fall	crosswordtracker.com/clue/figure-in-a-fall/
Garden of Eden figure	crosswordtracker.com/clue/garden-of-eden-figure/
"I don't know him from ___"	crosswordtracker.com/clue/i-dont-know-him-from-___/
"The Wealth of Nations" philosopher Smith	crosswordtracker.com/clue/the-wealth-of-nations-philosopher-smith/
Silly Sandler	crosswordtracker.com/clue/silly-sandler/
Sandler of "Happy Gilmore"	crosswordtracker.com/clue/sandler-of-happy-gilmore/
Figure on the ceiling of the Sistine Chapel	crosswordtracker.com/clue/figure-on-the-ceiling-of-the-sistine-chapel/
Figure on the Sistine Chapel ceiling	crosswordtracker.com/clue/figure-on-the-sistine-chapel-ceiling/
First lady's man	crosswordtracker.com/clue/first-ladys-man/
Disgraced gardener	crosswordtracker.com/clue/disgraced-gardener/
''Batman'' actor West	crosswordtracker.com/clue/batman-actor-west/
Ben Cartwright's eldest	crosswordtracker.com/clue/ben-cartwrights-eldest/
Being number one?	crosswordtracker.com/clue/being-number-one/
A Ponderosa son	crosswordtracker.com/clue/a-ponderosa-son/
Father of Seth	crosswordtracker.com/clue/father-of-seth/
"The Wealth of Nations" author Smith	crosswordtracker.com/clue/the-wealth-of-nations-author-smith/
Comedian Sandler	crosswordtracker.com/clue/comedian-sandler/
Noted exile	crosswordtracker.com/clue/noted-exile-2/
Grandfather of Enos	crosswordtracker.com/clue/grandfather-of-enos/
Rodin sculpture at the Met	crosswordtracker.com/clue/rodin-sculpture-at-the-met/
Biblical evictee	crosswordtracker.com/clue/biblical-evictee/
Sandler of Hollywood	crosswordtracker.com/clue/sandler-of-hollywood/
TV Batman West	crosswordtracker.com/clue/tv-batman-west/
First name	crosswordtracker.com/clue/first-name-374/
"Happy Gilmore" actor Sandler	crosswordtracker.com/clue/happy-gilmore-actor-sandler/
Seth's father	crosswordtracker.com/clue/seths-father/
Original donor	crosswordtracker.com/clue/original-donor/
First husband?	crosswordtracker.com/clue/first-husband-1/
Unborn person?	crosswordtracker.com/clue/unborn-person/
First father	crosswordtracker.com/clue/first-father/
"Batman" actor West	crosswordtracker.com/clue/batman-actor-west-1/
Man in a garden	crosswordtracker.com/clue/man-in-a-garden/
Genesis father of three	crosswordtracker.com/clue/genesis-father-of-three/
Eden inhabitant	crosswordtracker.com/clue/eden-inhabitant/
An original sinner	crosswordtracker.com/clue/an-original-sinner/
Rocker Ant	crosswordtracker.com/clue/rocker-ant/
A Cartwright	crosswordtracker.com/clue/a-cartwright/
_____ Clayton Powell	crosswordtracker.com/clue/_____-clayton-powell/
Rib donor	crosswordtracker.com/clue/rib-donor/
Everyone's ancestor	crosswordtracker.com/clue/everyones-ancestor/
Style of furniture	crosswordtracker.com/clue/style-of-furniture/
"___ Bede" (George Eliot novel)	crosswordtracker.com/clue/___-bede-george-eliot-novel/
Former "Loveline" host Carolla	crosswordtracker.com/clue/former-loveline-host-carolla/
U2 bassist Clayton	crosswordtracker.com/clue/u2-bassist-clayton/
West of Gotham	crosswordtracker.com/clue/west-of-gotham-3/
He could give a first-person account	crosswordtracker.com/clue/he-could-give-a-first-person-account/
First man on the scene	crosswordtracker.com/clue/first-man-on-the-scene/
"Bonanza" son	crosswordtracker.com/clue/bonanza-son-2/
One of the Ponderosa boys	crosswordtracker.com/clue/one-of-the-ponderosa-boys/
Race starter	crosswordtracker.com/clue/race-starter-3/
Horovitz or Yauch	crosswordtracker.com/clue/horovitz-or-yauch/
Man before there were men	crosswordtracker.com/clue/man-before-there-were-men/
Everyone's ancestor, ostensibly	crosswordtracker.com/clue/everyones-ancestor-ostensibly/
Man before men	crosswordtracker.com/clue/man-before-men/
Man who's first in line?	crosswordtracker.com/clue/man-whos-first-in-line/
Sandler of ''The Longest Yard''	crosswordtracker.com/clue/sandler-of-the-longest-yard/
It took six days for him to appear on the scene	crosswordtracker.com/clue/it-took-six-days-for-him-to-appear-on-the-scene/
One with a first-person account	crosswordtracker.com/clue/one-with-a-first-person-account/
Sandler of "Billy Madison"	crosswordtracker.com/clue/sandler-of-billy-madison/
First person in the Bible	crosswordtracker.com/clue/first-person-in-the-bible/
Man without a bellybutton?	crosswordtracker.com/clue/man-without-a-bellybutton/
Sistine ceiling subject	crosswordtracker.com/clue/sistine-ceiling-subject/
Famous evictee	crosswordtracker.com/clue/famous-evictee/
Biblical bone donor	crosswordtracker.com/clue/biblical-bone-donor/
Eve preceder	crosswordtracker.com/clue/eve-preceder/
Common ancestor?	crosswordtracker.com/clue/common-ancestor/
Husband of Eve	crosswordtracker.com/clue/husband-of-eve/
Eden gardener	crosswordtracker.com/clue/eden-gardener/
Pioneer gardener?	crosswordtracker.com/clue/pioneer-gardener/
''Madam, I'm __''	crosswordtracker.com/clue/madam-im-__/
Eden figure	crosswordtracker.com/clue/eden-figure/
Early forefather?	crosswordtracker.com/clue/early-forefather/
Hoss' big brother	crosswordtracker.com/clue/hoss-big-brother/
First family father	crosswordtracker.com/clue/first-family-father/
"__-12": '60s-'70s police drama	crosswordtracker.com/clue/__-12-60s-70s-police-drama/
''___-12,'' cop drama	crosswordtracker.com/clue/___-12-cop-drama/
Guy in a garden	crosswordtracker.com/clue/guy-in-a-garden/
Garden of Eden evictee	crosswordtracker.com/clue/garden-of-eden-evictee/
Abel's dad	crosswordtracker.com/clue/abels-dad/
First husband	crosswordtracker.com/clue/first-husband/
Garden of Eden guy	crosswordtracker.com/clue/garden-of-eden-guy/
Man related to everyone	crosswordtracker.com/clue/man-related-to-everyone/
"For Your Entertainment" singer Lambert	crosswordtracker.com/clue/for-your-entertainment-singer-lambert/
Sistine fresco figure	crosswordtracker.com/clue/sistine-fresco-figure/
See 93A	crosswordtracker.com/clue/see-93a/
First bone transplant donor?	crosswordtracker.com/clue/first-bone-transplant-donor/
Eve's Garden of Eden partner	crosswordtracker.com/clue/eves-garden-of-eden-partner/
Sistine Chapel fresco figure	crosswordtracker.com/clue/sistine-chapel-fresco-figure/
The younger Arkin	crosswordtracker.com/clue/the-younger-arkin/
___ West (Batman man)	crosswordtracker.com/clue/___-west-batman-man/
Batman, to Burt's Robin	crosswordtracker.com/clue/batman-to-burts-robin/
Sandler or Smith	crosswordtracker.com/clue/sandler-or-smith/
Sandler on the screen	crosswordtracker.com/clue/sandler-on-the-screen/
First in the race?	crosswordtracker.com/clue/first-in-the-race/
Sandler of "Click"	crosswordtracker.com/clue/sandler-of-click/
Arkin of "Chicago Hope"	crosswordtracker.com/clue/arkin-of-chicago-hope/
West of Gotham City fame	crosswordtracker.com/clue/west-of-gotham-city-fame/
Ponderosa boy	crosswordtracker.com/clue/ponderosa-boy/
''Bonanza'' son	crosswordtracker.com/clue/bonanza-son-1/
First person to be ribbed	crosswordtracker.com/clue/first-person-to-be-ribbed/
Zohan portrayer Sandler	crosswordtracker.com/clue/zohan-portrayer-sandler/
Gardener number one	crosswordtracker.com/clue/gardener-number-one/
First lady's man?	crosswordtracker.com/clue/first-ladys-man-1/
Displaced gardener	crosswordtracker.com/clue/displaced-gardener/
Ant or West	crosswordtracker.com/clue/ant-or-west/
Man of Genesis	crosswordtracker.com/clue/man-of-genesis/
The number one guy?	crosswordtracker.com/clue/the-number-one-guy/
Garden of Eden resident	crosswordtracker.com/clue/garden-of-eden-resident/
"___ Bede" (George Eliot's first novel)	crosswordtracker.com/clue/___-bede-george-eliots-first-novel/
West of Gotham City?	crosswordtracker.com/clue/west-of-gotham-city-2/
Man without a mother	crosswordtracker.com/clue/man-without-a-mother/
Brother on "Bonanza"	crosswordtracker.com/clue/brother-on-bonanza/
Singer Lambert	crosswordtracker.com/clue/singer-lambert/
Smith of note	crosswordtracker.com/clue/smith-of-note/
Singer Lambert, runner-up on the 2009 "American Idol"	crosswordtracker.com/clue/singer-lambert-runner-up-on-the-2009-american-idol/
Fictional inspector Dalgliesh	crosswordtracker.com/clue/fictional-inspector-dalgliesh/
One cast out of paradise	crosswordtracker.com/clue/one-cast-out-of-paradise/
The first prophet of God, in Islam	crosswordtracker.com/clue/the-first-prophet-of-god-in-islam/
He's seen on the ceiling of the Sistine Chapel	crosswordtracker.com/clue/hes-seen-on-the-ceiling-of-the-sistine-chapel/
"Fall" guy	crosswordtracker.com/clue/fall-guy-6/
Faithful servant in "As You Like It"	crosswordtracker.com/clue/faithful-servant-in-as-you-like-it/
First among men	crosswordtracker.com/clue/first-among-men/
Exile of note	crosswordtracker.com/clue/exile-of-note/
Party of the first part?	crosswordtracker.com/clue/party-of-the-first-part-1/
First one	crosswordtracker.com/clue/first-one-3/
Provider of the first bone transplant?	crosswordtracker.com/clue/provider-of-the-first-bone-transplant/
Place kicker Vinatieri	crosswordtracker.com/clue/place-kicker-vinatieri/
Genesis fall guy	crosswordtracker.com/clue/genesis-fall-guy/
Cain's dad	crosswordtracker.com/clue/cains-dad/
To whom God said "You are dust, and to dust you shall return"	crosswordtracker.com/clue/to-whom-god-said-you-are-dust-and-to-dust-you-shall-return/
First Prophet of Islam	crosswordtracker.com/clue/first-prophet-of-islam/
Someone who could give a first-person account?	crosswordtracker.com/clue/someone-who-could-give-a-first-person-account/
Sandler of "Spanglish"	crosswordtracker.com/clue/sandler-of-spanglish/
West of "Batman"	crosswordtracker.com/clue/west-of-batman/
Genesis 2 name	crosswordtracker.com/clue/genesis-2-name/
"The Wedding Singer" star Sandler	crosswordtracker.com/clue/the-wedding-singer-star-sandler/
Sandler of "Grown Ups"	crosswordtracker.com/clue/sandler-of-grown-ups/
Founding father?	crosswordtracker.com/clue/founding-father-4/
Someone with a first-person account?	crosswordtracker.com/clue/someone-with-a-first-person-account/
Michelangelo's fresco "The Creation of ___"	crosswordtracker.com/clue/michelangelos-fresco-the-creation-of-___/
Australian golfer __ Scott	crosswordtracker.com/clue/australian-golfer-__-scott/
Noted rib donor	crosswordtracker.com/clue/noted-rib-donor/
Sandler of "Little Nicky"	crosswordtracker.com/clue/sandler-of-little-nicky/
Sistine Chapel chap	crosswordtracker.com/clue/sistine-chapel-chap/
He has an apple named after him?	crosswordtracker.com/clue/he-has-an-apple-named-after-him/
Evictee from paradise	crosswordtracker.com/clue/evictee-from-paradise/
Polish poet Mickiewicz	crosswordtracker.com/clue/polish-poet-mickiewicz/
Genesis gentleman	crosswordtracker.com/clue/genesis-gentleman/
Man on first?	crosswordtracker.com/clue/man-on-first/
Man in Eden	crosswordtracker.com/clue/man-in-eden/
___ Clayton Powell Jr.	crosswordtracker.com/clue/___-clayton-powell-jr/
Man cast out of paradise	crosswordtracker.com/clue/man-cast-out-of-paradise/
Eve's predecessor	crosswordtracker.com/clue/eves-predecessor/
___ West of "Batman"	crosswordtracker.com/clue/___-west-of-batman/
One there in the first place	crosswordtracker.com/clue/one-there-in-the-first-place/
First of its kind?	crosswordtracker.com/clue/first-of-its-kind/
First given name in the Bible	crosswordtracker.com/clue/first-given-name-in-the-bible/
Famous rib donor	crosswordtracker.com/clue/famous-rib-donor/
Garden of Eden man	crosswordtracker.com/clue/garden-of-eden-man/
1910 Rodin sculpture at the Met	crosswordtracker.com/clue/1910-rodin-sculpture-at-the-met/
Dweller in Paradise	crosswordtracker.com/clue/dweller-in-paradise/
Classic Rodin sculpture	crosswordtracker.com/clue/classic-rodin-sculpture/
Not know from ___	crosswordtracker.com/clue/not-know-from-___/
One of TV's Cartwrights	crosswordtracker.com/clue/one-of-tvs-cartwrights/
Man with a spare rib?	crosswordtracker.com/clue/man-with-a-spare-rib/
Cain was his son	crosswordtracker.com/clue/cain-was-his-son/
Figure in a famous Sistine Chapel fresco	crosswordtracker.com/clue/figure-in-a-famous-sistine-chapel-fresco/
Sandler of comedy	crosswordtracker.com/clue/sandler-of-comedy/
Sandler who played Opera Man on "SNL"	crosswordtracker.com/clue/sandler-who-played-opera-man-on-snl/
One of Ben's boys on "Bonanza"	crosswordtracker.com/clue/one-of-bens-boys-on-bonanza/
"___ / Had 'em" (classic two-line poem about fleas)	crosswordtracker.com/clue/___-had-em-classic-two-line-poem-about-fleas/
West who played Batman	crosswordtracker.com/clue/west-who-played-batman/
French pianist-composer	crosswordtracker.com/clue/french-pianist-composer/
Original man	crosswordtracker.com/clue/original-man/
A first mate	crosswordtracker.com/clue/a-first-mate/
Enoch's grandfather	crosswordtracker.com/clue/enochs-grandfather/
TV's "___-12"	crosswordtracker.com/clue/tvs-___-12/
He was ribbed	crosswordtracker.com/clue/he-was-ribbed/
Memorable pome taster	crosswordtracker.com/clue/memorable-pome-taster/
Number-one man	crosswordtracker.com/clue/number-one-man/
"Cantique de Noël" composer	crosswordtracker.com/clue/cantique-de-noel-composer/
Apple of Eve's eye?	crosswordtracker.com/clue/apple-of-eves-eye/
A Trask in "East of Eden"	crosswordtracker.com/clue/a-trask-in-east-of-eden/
First of all of us	crosswordtracker.com/clue/first-of-all-of-us/
Comic-opera composer Adolphe ___	crosswordtracker.com/clue/comic-opera-composer-adolphe-___/
Brother of Hoss and Little Joe	crosswordtracker.com/clue/brother-of-hoss-and-little-joe/
First bone donor	crosswordtracker.com/clue/first-bone-donor/
Fatherless fellow	crosswordtracker.com/clue/fatherless-fellow/
Paradise evictee	crosswordtracker.com/clue/paradise-evictee/
Human #1	crosswordtracker.com/clue/human-1/
Sandler of "Saturday Night Live"	crosswordtracker.com/clue/sandler-of-saturday-night-live/
Not know from _____	crosswordtracker.com/clue/not-know-from-_____/
Edenite	crosswordtracker.com/clue/edenite/
One of the Arkins	crosswordtracker.com/clue/one-of-the-arkins/
TV's "___ 12"	crosswordtracker.com/clue/tvs-___-12-1/
Eden's proprietor	crosswordtracker.com/clue/edens-proprietor/
Eliot's "___ Bede"	crosswordtracker.com/clue/eliots-___-bede/
West of Batman fame	crosswordtracker.com/clue/west-of-batman-fame/
First person to take a ribbing	crosswordtracker.com/clue/first-person-to-take-a-ribbing/
West of "Batman" fame	crosswordtracker.com/clue/west-of-batman-fame-1/
"___ 12," TV oldie	crosswordtracker.com/clue/___-12-tv-oldie/
The first lover	crosswordtracker.com/clue/the-first-lover/
French composer Adolphe ___	crosswordtracker.com/clue/french-composer-adolphe-___/
A memorable Powell	crosswordtracker.com/clue/a-memorable-powell/
English furniture style	crosswordtracker.com/clue/english-furniture-style/
He sounds like a bomb, kind of	crosswordtracker.com/clue/he-sounds-like-a-bomb-kind-of/
G. Eliot's "___ Bede"	crosswordtracker.com/clue/g-eliots-___-bede/
First donor?	crosswordtracker.com/clue/first-donor/
Second sinner	crosswordtracker.com/clue/second-sinner/
Bede or Smith	crosswordtracker.com/clue/bede-or-smith/
G. Eliot drew a Bede on him	crosswordtracker.com/clue/g-eliot-drew-a-bede-on-him/
One of the Smiths	crosswordtracker.com/clue/one-of-the-smiths/
Rock star Ant	crosswordtracker.com/clue/rock-star-ant/
Rocker ___ Ant	crosswordtracker.com/clue/rocker-___-ant/
Smith who wrote The Theory of Moral Sentiments	crosswordtracker.com/clue/smith-who-wrote-the-theory-of-moral-sentiments/
Book of Genesis character	crosswordtracker.com/clue/book-of-genesis-character/
Diarist in a Mark Twain story	crosswordtracker.com/clue/diarist-in-a-mark-twain-story/
Title dad in a comic strip by Brian Basset	crosswordtracker.com/clue/title-dad-in-a-comic-strip-by-brian-basset/
Counting Crows singer Duritz	crosswordtracker.com/clue/counting-crows-singer-duritz/
Brody of "The O.C."	crosswordtracker.com/clue/brody-of-the-oc/
Placekicker Vinatieri	crosswordtracker.com/clue/placekicker-vinatieri/
Relief pitcher Wainwright	crosswordtracker.com/clue/relief-pitcher-wainwright/
Pacman Jones's real first name	crosswordtracker.com/clue/pacman-joness-real-first-name/
Apple	crosswordtracker.com/clue/apple-358/
Goldberg of "2 Days in Paris"	crosswordtracker.com/clue/goldberg-of-2-days-in-paris/
District attorney Schiff on "Law & Order"	crosswordtracker.com/clue/district-attorney-schiff-on-law-order/
Sandler of I Now Pronounce You Chuck and Larry	crosswordtracker.com/clue/sandler-of-i-now-pronounce-you-chuck-and-larry/
Bassist Schlesinger of Fountains of Wayne	crosswordtracker.com/clue/bassist-schlesinger-of-fountains-of-wayne/
Colts placekicker Vinatieri	crosswordtracker.com/clue/colts-placekicker-vinatieri/
Pascal of "Rent"	crosswordtracker.com/clue/pascal-of-rent/
Drew's "50 First Dates" costar	crosswordtracker.com/clue/drews-50-first-dates-costar/
Emily's "Punch-Drunk Love" costar	crosswordtracker.com/clue/emilys-punch-drunk-love-costar/
RADIO PERSONALITY CAROLLA	crosswordtracker.com/clue/radio-personality-carolla/
West who plays the mayor on "Family Guy"	crosswordtracker.com/clue/west-who-plays-the-mayor-on-family-guy/
Radio host Carolla	crosswordtracker.com/clue/radio-host-carolla/
Don's "Reign Over Me" costar	crosswordtracker.com/clue/dons-reign-over-me-costar/
Earth's first gardener?	crosswordtracker.com/clue/earths-first-gardener/
____Van Koeverden (winner of kayak silver)	crosswordtracker.com/clue/____van-koeverden-winner-of-kayak-silver/
Partner of Eve	crosswordtracker.com/clue/partner-of-eve-1/
First gardener?	crosswordtracker.com/clue/first-gardener/
Eden occupant	crosswordtracker.com/clue/eden-occupant/
Noted fruit fancier	crosswordtracker.com/clue/noted-fruit-fancier/
Unborn person	crosswordtracker.com/clue/unborn-person-1/
Sandler of films	crosswordtracker.com/clue/sandler-of-films/
Number one guy?	crosswordtracker.com/clue/number-one-guy/
First gardener	crosswordtracker.com/clue/first-gardener-1/
Heir to the Ponderosa	crosswordtracker.com/clue/heir-to-the-ponderosa/
Ben's oldest son on "Bonanza"	crosswordtracker.com/clue/bens-oldest-son-on-bonanza/
He's #1!	crosswordtracker.com/clue/hes-1-1/
West or Ant	crosswordtracker.com/clue/west-or-ant/
First man to be "ribbed"	crosswordtracker.com/clue/first-man-to-be-ribbed/
Eden patriarch	crosswordtracker.com/clue/eden-patriarch/
He had no mother	crosswordtracker.com/clue/he-had-no-mother/
Someone who could give a first-person account	crosswordtracker.com/clue/someone-who-could-give-a-first-person-account-1/
He once lived in a garden	crosswordtracker.com/clue/he-once-lived-in-a-garden/
He has an apple named after him	crosswordtracker.com/clue/he-has-an-apple-named-after-him-1/
First in a long line?	crosswordtracker.com/clue/first-in-a-long-line/
Rodin piece	crosswordtracker.com/clue/rodin-piece/
Fired gardener	crosswordtracker.com/clue/fired-gardener/
Man with an apple named after him?	crosswordtracker.com/clue/man-with-an-apple-named-after-him/
He's number one	crosswordtracker.com/clue/hes-number-one/
One with a first-person account?	crosswordtracker.com/clue/one-with-a-first-person-account-1/
First in the race	crosswordtracker.com/clue/first-in-the-race-1/
First fellow	crosswordtracker.com/clue/first-fellow/
"She shall be called Woman" speaker	crosswordtracker.com/clue/she-shall-be-called-woman-speaker/
"Wealth of Nations" author Smith	crosswordtracker.com/clue/wealth-of-nations-author-smith/
Baldwin or Sandler	crosswordtracker.com/clue/baldwin-or-sandler/
Yauch of the Beastie Boys	crosswordtracker.com/clue/yauch-of-the-beastie-boys/
Sandler who played Canteen Boy	crosswordtracker.com/clue/sandler-who-played-canteen-boy/
Beastie Boy Yauch	crosswordtracker.com/clue/beastie-boy-yauch/
Primal man?	crosswordtracker.com/clue/primal-man/
Levine of "The Voice"	crosswordtracker.com/clue/levine-of-the-voice/
___ and Steve (variation on a biblical pair)	crosswordtracker.com/clue/___-and-steve-variation-on-a-biblical-pair/
Scott of "Parks and Recreation" [The AV Club goes subscription only soon! Sign up at avxword.com]	crosswordtracker.com/clue/scott-of-parks-and-recreation-the-av-club-goes-subscription-only-soon-sign-up-at-avxwordcom/
Economist Smith who coined the term "invisible hand"	crosswordtracker.com/clue/economist-smith-who-coined-the-term-invisible-hand/
Sistine Chapel ceiling subject	crosswordtracker.com/clue/sistine-chapel-ceiling-subject/
Leading man?	http://www.crosswordgiant.com/crossword-clue/11080/Leading-man
Economist Smith	http://www.crosswordgiant.com/crossword-clue/2359/Economist-Smith
Leading man	http://www.crosswordgiant.com/crossword-clue/218523/Leading-man
First person	http://www.crosswordgiant.com/crossword-clue/122159/First-person
First of all	http://www.crosswordgiant.com/crossword-clue/43038/First-of-all
Sixth-day creation	http://www.crosswordgiant.com/crossword-clue/8165/Sixth-day-creation
First of all?	http://www.crosswordgiant.com/crossword-clue/118373/First-of-all
First man	http://www.crosswordgiant.com/crossword-clue/470432/First-man
First name?	http://www.crosswordgiant.com/crossword-clue/24647/First-name
Original sinner	http://www.crosswordgiant.com/crossword-clue/4810/Original-sinner
First fellow	http://www.crosswordgiant.com/crossword-clue/227781/First-fellow
Genesis man	http://www.crosswordgiant.com/crossword-clue/77844/Genesis-man
Eden evictee	http://www.crosswordgiant.com/crossword-clue/219514/Eden-evictee
'Paradise Lost' character	http://www.crosswordgiant.com/crossword-clue/7196/Paradise-Lost-character
First mate?	http://www.crosswordgiant.com/crossword-clue/12101/First-mate
Eden dweller	http://www.crosswordgiant.com/crossword-clue/18872/Eden-dweller
Rodin sculpture	http://www.crosswordgiant.com/crossword-clue/120535/Rodin-sculpture
Garden party?	http://www.crosswordgiant.com/crossword-clue/53716/Garden-party
Sistine Chapel figure	http://www.crosswordgiant.com/crossword-clue/101556/Sistine-Chapel-figure
"Bonanza" brother	http://www.crosswordgiant.com/crossword-clue/232622/Bonanza-brother
Cain raiser	http://www.crosswordgiant.com/crossword-clue/20157/Cain-raiser
Brother of Little Joe	http://www.crosswordgiant.com/crossword-clue/141787/Brother-of-Little-Joe
Eve's mate	http://www.crosswordgiant.com/crossword-clue/273626/Eves-mate
A mad sort of ancestor	http://www.crosswordgiant.com/crossword-clue/953495/A-mad-sort-of-ancestor
First father	http://www.crosswordgiant.com/crossword-clue/175524/First-father
First name	http://www.crosswordgiant.com/crossword-clue/221619/First-name
Noted bone donor	http://www.crosswordgiant.com/crossword-clue/285441/Noted-bone-donor
Comic Sandler	http://www.crosswordgiant.com/crossword-clue/309771/Comic-Sandler
Sistine Chapel ceiling figure	http://www.crosswordgiant.com/crossword-clue/517689/Sistine-Chapel-ceiling-figure
Cain's father	http://www.crosswordgiant.com/crossword-clue/577773/Cains-father
Sistine ceiling figure	http://www.crosswordgiant.com/crossword-clue/147383/Sistine-ceiling-figure
Abel's father	http://www.crosswordgiant.com/crossword-clue/431411/Abels-father
'As You Like It' servant	http://www.crosswordgiant.com/crossword-clue/13368/As-You-Like-It-servant
West of Hollywood	http://www.crosswordgiant.com/crossword-clue/16912/West-of-Hollywood
Early evictee	http://www.crosswordgiant.com/crossword-clue/22286/Early-evictee
Fall guy?	http://www.crosswordgiant.com/crossword-clue/40647/Fall-guy
Funnyman Sandler	http://www.crosswordgiant.com/crossword-clue/68385/Funnyman-Sandler
Rodin sculpture at the Met	http://www.crosswordgiant.com/crossword-clue/75558/Rodin-sculpture-at-the-Met
Unborn person?	http://www.crosswordgiant.com/crossword-clue/85794/Unborn-person
Man who was never born	http://www.crosswordgiant.com/crossword-clue/110193/Man-who-was-never-born
He had no mother	http://www.crosswordgiant.com/crossword-clue/113103/He-had-no-mother
Man in Eden	http://www.crosswordgiant.com/crossword-clue/133800/Man-in-Eden
He raised Cain	http://www.crosswordgiant.com/crossword-clue/168501/He-raised-Cain
The #1 guy?	http://www.crosswordgiant.com/crossword-clue/173064/The-1-guy
Genesis patriarch	http://www.crosswordgiant.com/crossword-clue/188332/Genesis-patriarch
First Family member	http://www.crosswordgiant.com/crossword-clue/241287/First-Family-member
Garden figure	http://www.crosswordgiant.com/crossword-clue/244136/Garden-figure
Sixth day creation	http://www.crosswordgiant.com/crossword-clue/244155/Sixth-day-creation
Eden resident	http://www.crosswordgiant.com/crossword-clue/292751/Eden-resident
One who raised Cain	http://www.crosswordgiant.com/crossword-clue/303834/One-who-raised-Cain
Father of Cain and Abel	http://www.crosswordgiant.com/crossword-clue/332122/Father-of-Cain-and-Abel
Eden guy	http://www.crosswordgiant.com/crossword-clue/573250/Eden-guy
Sistine Chapel subject	http://www.crosswordgiant.com/crossword-clue/667245/Sistine-Chapel-subject
Cain and Abel's dad	http://www.crosswordgiant.com/crossword-clue/701084/Cain-and-Abels-dad
Eve's husband	http://www.crosswordgiant.com/crossword-clue/837419/Eves-husband
Being No. 1?	http://www.crosswordgiant.com/crossword-clue/1442922/Being-No.-1
Levine of Maroon 5	http://www.crosswordgiant.com/crossword-clue/1491841/Levine-of-Maroon-5
Genesis name	http://www.crosswordgiant.com/crossword-clue/7252/Genesis-name
Man in a garden	http://www.crosswordgiant.com/crossword-clue/66579/Man-in-a-garden
Early exile	http://www.crosswordgiant.com/crossword-clue/132319/Early-exile
An apple was named after him	http://www.crosswordgiant.com/crossword-clue/132590/An-apple-was-named-after-him
"Batman" actor West	http://www.crosswordgiant.com/crossword-clue/142570/Batman-actor-West
''Bonanza'' brother	http://www.crosswordgiant.com/crossword-clue/146624/Bonanza-brother
First-family member	http://www.crosswordgiant.com/crossword-clue/147174/First-family-member
First grandfather	http://www.crosswordgiant.com/crossword-clue/150474/First-grandfather
Early fruit fancier	http://www.crosswordgiant.com/crossword-clue/163821/Early-fruit-fancier
Eve's man	http://www.crosswordgiant.com/crossword-clue/174722/Eves-man
West of Gotham	http://www.crosswordgiant.com/crossword-clue/196168/West-of-Gotham
Sandler of 'Big Daddy'	http://www.crosswordgiant.com/crossword-clue/203995/Sandler-of-Big-Daddy
Disgraced gardener	http://www.crosswordgiant.com/crossword-clue/216149/Disgraced-gardener
First mate	http://www.crosswordgiant.com/crossword-clue/240990/First-mate
First in a long line?	http://www.crosswordgiant.com/crossword-clue/247830/First-in-a-long-line
Famous evictee	http://www.crosswordgiant.com/crossword-clue/251064/Famous-evictee
First  person	http://www.crosswordgiant.com/crossword-clue/253644/First-person
Displaced gardener	http://www.crosswordgiant.com/crossword-clue/255598/Displaced-gardener
Raiser of Cain	http://www.crosswordgiant.com/crossword-clue/268906/Raiser-of-Cain
Rib relinquisher	http://www.crosswordgiant.com/crossword-clue/284269/Rib-relinquisher
Grandfather of 134 Across	http://www.crosswordgiant.com/crossword-clue/294034/Grandfather-of-134-Across
Grandfather of Enos	http://www.crosswordgiant.com/crossword-clue/300604/Grandfather-of-Enos
One of the Ponderosa boys	http://www.crosswordgiant.com/crossword-clue/301299/One-of-the-Ponderosa-boys
Ben Cartwright's eldest	http://www.crosswordgiant.com/crossword-clue/303417/Ben-Cartwrights-eldest
Father of Seth	http://www.crosswordgiant.com/crossword-clue/305068/Father-of-Seth
Party of the first part?	http://www.crosswordgiant.com/crossword-clue/313567/Party-of-the-first-part
First one	http://www.crosswordgiant.com/crossword-clue/313728/First-one
Provider of the first bone transplant?	http://www.crosswordgiant.com/crossword-clue/325224/Provider-of-the-first-bone-transplant
''___ Bede'' (George Eliot novel)	http://www.crosswordgiant.com/crossword-clue/326092/___-Bede-George-Eliot-novel
Rib donor	http://www.crosswordgiant.com/crossword-clue/329326/Rib-donor
Sistine Chapel depiction	http://www.crosswordgiant.com/crossword-clue/412695/Sistine-Chapel-depiction
Genesis figure	http://www.crosswordgiant.com/crossword-clue/422001/Genesis-figure
Race starter?	http://www.crosswordgiant.com/crossword-clue/463028/Race-starter
Eve's spouse	http://www.crosswordgiant.com/crossword-clue/465891/Eves-spouse
Actor Sandler	http://www.crosswordgiant.com/crossword-clue/502814/Actor-Sandler
''Batman'' actor West	http://www.crosswordgiant.com/crossword-clue/513412/Batman-actor-West
Ponderosa boy	http://www.crosswordgiant.com/crossword-clue/519269/Ponderosa-boy
Enos' grandpa	http://www.crosswordgiant.com/crossword-clue/558051/Enos-grandpa
First family member?	http://www.crosswordgiant.com/crossword-clue/576160/First-family-member
''As You Like It'' servant	http://www.crosswordgiant.com/crossword-clue/590704/As-You-Like-It-servant
Wagnalls of Funk & Wagnalls	http://www.crosswordgiant.com/crossword-clue/592512/Wagnalls-of-Funk-Wagnalls
Smith or Sandler	http://www.crosswordgiant.com/crossword-clue/595411/Smith-or-Sandler
Being number one?	http://www.crosswordgiant.com/crossword-clue/636141/Being-number-one
"Back to the Batcave" autobiographer West	http://www.crosswordgiant.com/crossword-clue/668961/Back-to-the-Batcave-autobiographer-West
Ant who sings	http://www.crosswordgiant.com/crossword-clue/672361/Ant-who-sings
Sistine fresco figure	http://www.crosswordgiant.com/crossword-clue/697824/Sistine-fresco-figure
U2 bassist Clayton	http://www.crosswordgiant.com/crossword-clue/711157/U2-bassist-Clayton
Eve's partner	http://www.crosswordgiant.com/crossword-clue/742970/Eves-partner
Garden of Eden figure	http://www.crosswordgiant.com/crossword-clue/772244/Garden-of-Eden-figure
Singer Lambert	http://www.crosswordgiant.com/crossword-clue/790530/Singer-Lambert
Sandler of Hollywood	http://www.crosswordgiant.com/crossword-clue/877716/Sandler-of-Hollywood
TV Batman West	http://www.crosswordgiant.com/crossword-clue/886795/TV-Batman-West
"Happy Gilmore" actor Sandler	http://www.crosswordgiant.com/crossword-clue/905748/Happy-Gilmore-actor-Sandler
Eden inhabitant	http://www.crosswordgiant.com/crossword-clue/914898/Eden-inhabitant
According to the Bible, progenitor of the human race	http://www.crosswordgiant.com/crossword-clue/1021088/According-to-the-Bible-progenitor-of-the-human-race
A mother? No, a father	http://www.crosswordgiant.com/crossword-clue/1157783/A-mother-No-a-father
'Mother? No, father (4)'	http://www.crosswordgiant.com/crossword-clue/1174050/Mother-No-father-4
A mother and father figure	http://www.crosswordgiant.com/crossword-clue/1267492/A-mother-and-father-figure
Dustman	http://www.crosswordgiant.com/crossword-clue/1273177/Dustman
He fell out of sympathy with his partner	http://www.crosswordgiant.com/crossword-clue/1293349/He-fell-out-of-sympathy-with-his-partner
First husband?	http://www.crosswordgiant.com/crossword-clue/1417211/First-husband
Economist Smith who coined the term 'invisible hand'	http://www.crosswordgiant.com/crossword-clue/1483705/Economist-Smith-who-coined-the-term-invisible-hand
Cain's pop	http://www.crosswordgiant.com/crossword-clue/1486138/Cains-pop
Sistine Chapel ceiling subject	http://www.crosswordgiant.com/crossword-clue/1486190/Sistine-Chapel-ceiling-subject
1910 Rodin sculpture at the Met	http://www.crosswordgiant.com/crossword-clue/432/1910-Rodin-sculpture-at-the-Met
Dweller in Paradise	http://www.crosswordgiant.com/crossword-clue/3834/Dweller-in-Paradise
Resident of 63-Across	http://www.crosswordgiant.com/crossword-clue/20484/Resident-of-63-Across
Actor Baldwin	http://www.crosswordgiant.com/crossword-clue/21500/Actor-Baldwin
Classic Rodin sculpture	http://www.crosswordgiant.com/crossword-clue/23137/Classic-Rodin-sculpture
Fall guy	http://www.crosswordgiant.com/crossword-clue/26601/Fall-guy
Not know from ___	http://www.crosswordgiant.com/crossword-clue/27625/Not-know-from-___
Role in Haydn's 'The Creation'	http://www.crosswordgiant.com/crossword-clue/34168/Role-in-Haydns-The-Creation
One of TV's Cartwrights	http://www.crosswordgiant.com/crossword-clue/49627/One-of-TVs-Cartwrights
'Bonanza' brother	http://www.crosswordgiant.com/crossword-clue/50298/Bonanza-brother
Man with a spare rib?	http://www.crosswordgiant.com/crossword-clue/55235/Man-with-a-spare-rib
Figure on the ceiling of the Sistine Chapel	http://www.crosswordgiant.com/crossword-clue/58639/Figure-on-the-ceiling-of-the-Sistine-Chapel
Cain was his son	http://www.crosswordgiant.com/crossword-clue/59282/Cain-was-his-son
As old as ___	http://www.crosswordgiant.com/crossword-clue/60818/As-old-as-___
21-Across of 6-Down	http://www.crosswordgiant.com/crossword-clue/77532/21-Across-of-6-Down
Noted exile	http://www.crosswordgiant.com/crossword-clue/81127/Noted-exile
Eden patriarch	http://www.crosswordgiant.com/crossword-clue/103475/Eden-patriarch
See 83-Across	http://www.crosswordgiant.com/crossword-clue/112586/See-83-Across
First in the race	http://www.crosswordgiant.com/crossword-clue/142925/First-in-the-race
Someone who could give a first-person account	http://www.crosswordgiant.com/crossword-clue/147777/Someone-who-could-give-a-first-person-account
He once lived in a garden	http://www.crosswordgiant.com/crossword-clue/150787/He-once-lived-in-a-garden
First man on the scene	http://www.crosswordgiant.com/crossword-clue/158532/First-man-on-the-scene
Race starter	http://www.crosswordgiant.com/crossword-clue/162133/Race-starter
Eden exile	http://www.crosswordgiant.com/crossword-clue/171654/Eden-exile
___ Clayton Powell Jr.	http://www.crosswordgiant.com/crossword-clue/180448/___-Clayton-Powell-Jr
Actor Arkin	http://www.crosswordgiant.com/crossword-clue/186359/Actor-Arkin
Noted fruit fancier	http://www.crosswordgiant.com/crossword-clue/196601/Noted-fruit-fancier
He has an apple named after him	http://www.crosswordgiant.com/crossword-clue/206385/He-has-an-apple-named-after-him
"Bonanza" son	http://www.crosswordgiant.com/crossword-clue/209845/Bonanza-son
Rocker Ant	http://www.crosswordgiant.com/crossword-clue/220285/Rocker-Ant
Unborn person	http://www.crosswordgiant.com/crossword-clue/234360/Unborn-person
Father of 49-Across	http://www.crosswordgiant.com/crossword-clue/235605/Father-of-49-Across
Man cast out of paradise	http://www.crosswordgiant.com/crossword-clue/236768/Man-cast-out-of-paradise
Motherless one?	http://www.crosswordgiant.com/crossword-clue/237082/Motherless-one
First resident of 61-Across	http://www.crosswordgiant.com/crossword-clue/237289/First-resident-of-61-Across
Eve's predecessor	http://www.crosswordgiant.com/crossword-clue/240611/Eves-predecessor
Grandfather of 16-Across	http://www.crosswordgiant.com/crossword-clue/242240/Grandfather-of-16-Across
Garden evictee	http://www.crosswordgiant.com/crossword-clue/246013/Garden-evictee
___ West of 'Batman'	http://www.crosswordgiant.com/crossword-clue/260784/___-West-of-Batman
'Bonanza' role	http://www.crosswordgiant.com/crossword-clue/262055/Bonanza-role
Sandler of films	http://www.crosswordgiant.com/crossword-clue/262280/Sandler-of-films
Number one guy?	http://www.crosswordgiant.com/crossword-clue/267770/Number-one-guy
Rodin piece	http://www.crosswordgiant.com/crossword-clue/268975/Rodin-piece
First  fellow	http://www.crosswordgiant.com/crossword-clue/272307/First-fellow
Hoss' brother	http://www.crosswordgiant.com/crossword-clue/272794/Hoss-brother
One there in the first place	http://www.crosswordgiant.com/crossword-clue/276436/One-there-in-the-first-place
With 69-Across, caped crusader player of 1966	http://www.crosswordgiant.com/crossword-clue/278463/With-69-Across-caped-crusader-player-of-1966
Fired gardener	http://www.crosswordgiant.com/crossword-clue/284802/Fired-gardener
''Bonanza'' role	http://www.crosswordgiant.com/crossword-clue/297903/Bonanza-role
Man with an apple named after him?	http://www.crosswordgiant.com/crossword-clue/306869/Man-with-an-apple-named-after-him
Little Joe's brother	http://www.crosswordgiant.com/crossword-clue/309392/Little-Joes-brother
He's number one	http://www.crosswordgiant.com/crossword-clue/311049/Hes-number-one
First gardener	http://www.crosswordgiant.com/crossword-clue/312376/First-gardener
Heir to the Ponderosa	http://www.crosswordgiant.com/crossword-clue/329655/Heir-to-the-Ponderosa
Creation on the sixth day	http://www.crosswordgiant.com/crossword-clue/329950/Creation-on-the-sixth-day
Biblical evictee	http://www.crosswordgiant.com/crossword-clue/334642/Biblical-evictee
Enos' grandfather	http://www.crosswordgiant.com/crossword-clue/334808/Enos-grandfather
One with a first-person account?	http://www.crosswordgiant.com/crossword-clue/336732/One-with-a-first-person-account
Guy in a garden	http://www.crosswordgiant.com/crossword-clue/380797/Guy-in-a-garden
Part for Pernell	http://www.crosswordgiant.com/crossword-clue/391581/Part-for-Pernell
Cain's old man	http://www.crosswordgiant.com/crossword-clue/391985/Cains-old-man
Enos' granddad	http://www.crosswordgiant.com/crossword-clue/400813/Enos-granddad
Garden of Eden evictee	http://www.crosswordgiant.com/crossword-clue/402929/Garden-of-Eden-evictee
First lady's man	http://www.crosswordgiant.com/crossword-clue/411181/First-ladys-man
Father of 9-Down	http://www.crosswordgiant.com/crossword-clue/412070/Father-of-9-Down
"Bonanza" role	http://www.crosswordgiant.com/crossword-clue/414426/Bonanza-role
Abel's dad	http://www.crosswordgiant.com/crossword-clue/416026/Abels-dad
Faithful servant in 'As You Like It'	http://www.crosswordgiant.com/crossword-clue/426745/Faithful-servant-in-As-You-Like-It
First husband	http://www.crosswordgiant.com/crossword-clue/431925/First-husband
First fall guy?	http://www.crosswordgiant.com/crossword-clue/432395/First-fall-guy
Emily's "Punch-Drunk Love" costar	http://www.crosswordgiant.com/crossword-clue/435055/Emilys-Punch-Drunk-Love-costar
First gardener?	http://www.crosswordgiant.com/crossword-clue/436840/First-gardener
Figure in a fall	http://www.crosswordgiant.com/crossword-clue/445955/Figure-in-a-fall
West of Gotham City fame	http://www.crosswordgiant.com/crossword-clue/447054/West-of-Gotham-City-fame
Horovitz or Yauch	http://www.crosswordgiant.com/crossword-clue/449272/Horovitz-or-Yauch
With 51-Across, Caped Crusader portrayer	http://www.crosswordgiant.com/crossword-clue/449726/With-51-Across-Caped-Crusader-portrayer
RADIO PERSONALITY CAROLLA	http://www.crosswordgiant.com/crossword-clue/452523/RADIO-PERSONALITY-CAROLLA
First among men	http://www.crosswordgiant.com/crossword-clue/452926/First-among-men
Garden transplant?	http://www.crosswordgiant.com/crossword-clue/469677/Garden-transplant
First name?	http://www.crosswordgiant.com/crossword-clue/481001/First-name
Exile of note	http://www.crosswordgiant.com/crossword-clue/485541/Exile-of-note
Garden dweller	http://www.crosswordgiant.com/crossword-clue/488162/Garden-dweller
Comedian Sandler	http://www.crosswordgiant.com/crossword-clue/488739/Comedian-Sandler
Early gardener?	http://www.crosswordgiant.com/crossword-clue/494567/Early-gardener
First on the scene?	http://www.crosswordgiant.com/crossword-clue/497291/First-on-the-scene
Pioneer gardener?	http://www.crosswordgiant.com/crossword-clue/509655/Pioneer-gardener
West who plays the mayor on "Family Guy"	http://www.crosswordgiant.com/crossword-clue/511177/West-who-plays-the-mayor-on-Family-Guy
First place resident?	http://www.crosswordgiant.com/crossword-clue/517462/First-place-resident
''Madam, I'm __''	http://www.crosswordgiant.com/crossword-clue/520510/Madam-Im-__
Eden figure	http://www.crosswordgiant.com/crossword-clue/523593/Eden-figure
Early forefather?	http://www.crosswordgiant.com/crossword-clue/527783/Early-forefather
Hoss' big brother	http://www.crosswordgiant.com/crossword-clue/528046/Hoss-big-brother
Eden occupant	http://www.crosswordgiant.com/crossword-clue/529073/Eden-occupant
First family father	http://www.crosswordgiant.com/crossword-clue/529078/First-family-father
'Madam, I'm ___'	http://www.crosswordgiant.com/crossword-clue/533215/Madam-Im-___
"__-12": '60s-'70s police drama	http://www.crosswordgiant.com/crossword-clue/537687/__-12-60s-70s-police-drama
See 93A	http://www.crosswordgiant.com/crossword-clue/542136/See-93A
'She shall be called Woman' speaker	http://www.crosswordgiant.com/crossword-clue/543605/She-shall-be-called-Woman-speaker
''___-12,'' cop drama	http://www.crosswordgiant.com/crossword-clue/545620/___-12-cop-drama
''Bonanza'' son	http://www.crosswordgiant.com/crossword-clue/546183/Bonanza-son
First bone transplant donor?	http://www.crosswordgiant.com/crossword-clue/548018/First-bone-transplant-donor
First to arrive?	http://www.crosswordgiant.com/crossword-clue/549978/First-to-arrive
Partner of 132-Across	http://www.crosswordgiant.com/crossword-clue/557340/Partner-of-132-Across
'Wealth of Nations' author Smith	http://www.crosswordgiant.com/crossword-clue/558822/Wealth-of-Nations-author-Smith
Trask in ''East of Eden''	http://www.crosswordgiant.com/crossword-clue/566569/Trask-in-East-of-Eden
Radio host Carolla	http://www.crosswordgiant.com/crossword-clue/574002/Radio-host-Carolla
The first prophet of God, in Islam	http://www.crosswordgiant.com/crossword-clue/575271/The-first-prophet-of-God-in-Islam
Sandler of ''The Longest Yard''	http://www.crosswordgiant.com/crossword-clue/585636/Sandler-of-The-Longest-Yard
Genesis progenitor	http://www.crosswordgiant.com/crossword-clue/587575/Genesis-progenitor
First person?	http://www.crosswordgiant.com/crossword-clue/587833/First-person
Don's "Reign Over Me" costar	http://www.crosswordgiant.com/crossword-clue/587904/Dons-Reign-Over-Me-costar
He's seen on the ceiling of the Sistine Chapel	http://www.crosswordgiant.com/crossword-clue/593289/Hes-seen-on-the-ceiling-of-the-Sistine-Chapel
Eliot's Bede	http://www.crosswordgiant.com/crossword-clue/597919/Eliots-Bede
First person to be ribbed	http://www.crosswordgiant.com/crossword-clue/609445/First-person-to-be-ribbed
'Fall' guy	http://www.crosswordgiant.com/crossword-clue/610529/Fall-guy
Former "Loveline" host Carolla	http://www.crosswordgiant.com/crossword-clue/620273/Former-Loveline-host-Carolla
Former 'Loveline' host Carolla	http://www.crosswordgiant.com/crossword-clue/620703/Former-Loveline-host-Carolla
Zohan portrayer Sandler	http://www.crosswordgiant.com/crossword-clue/623395/Zohan-portrayer-Sandler
It took six days for him to appear on the scene	http://www.crosswordgiant.com/crossword-clue/624083/It-took-six-days-for-him-to-appear-on-the-scene
Yauch of the Beastie Boys	http://www.crosswordgiant.com/crossword-clue/639978/Yauch-of-the-Beastie-Boys
One with a first-person account	http://www.crosswordgiant.com/crossword-clue/652096/One-with-a-first-person-account
Sandler of "Billy Madison"	http://www.crosswordgiant.com/crossword-clue/656836/Sandler-of-Billy-Madison
First person in the Bible	http://www.crosswordgiant.com/crossword-clue/669908/First-person-in-the-Bible
Man without a bellybutton?	http://www.crosswordgiant.com/crossword-clue/673302/Man-without-a-bellybutton
Eve's man	http://www.crosswordgiant.com/crossword-clue/678239/Eves-man
Man before there were men	http://www.crosswordgiant.com/crossword-clue/680971/Man-before-there-were-men
Sistine ceiling subject	http://www.crosswordgiant.com/crossword-clue/681381/Sistine-ceiling-subject
Gardener number one	http://www.crosswordgiant.com/crossword-clue/689513/Gardener-number-one
First of billions	http://www.crosswordgiant.com/crossword-clue/692269/First-of-billions
Little Joe's brother	http://www.crosswordgiant.com/crossword-clue/692305/Little-Joes-brother
Biblical bone donor	http://www.crosswordgiant.com/crossword-clue/701654/Biblical-bone-donor
A Ponderosa son	http://www.crosswordgiant.com/crossword-clue/702892/A-Ponderosa-son
Eve preceder	http://www.crosswordgiant.com/crossword-clue/703550/Eve-preceder
Common ancestor?	http://www.crosswordgiant.com/crossword-clue/715856/Common-ancestor
Sandler who played Canteen Boy	http://www.crosswordgiant.com/crossword-clue/717344/Sandler-who-played-Canteen-Boy
Husband of Eve	http://www.crosswordgiant.com/crossword-clue/718837/Husband-of-Eve
Smith of note	http://www.crosswordgiant.com/crossword-clue/719554/Smith-of-note
First lady's man?	http://www.crosswordgiant.com/crossword-clue/723078/First-ladys-man
Original fellow	http://www.crosswordgiant.com/crossword-clue/724104/Original-fellow
Beastie Boy Yauch	http://www.crosswordgiant.com/crossword-clue/731100/Beastie-Boy-Yauch
Sandler of "Funny People"	http://www.crosswordgiant.com/crossword-clue/732670/Sandler-of-Funny-People
Everyone's ancestor, ostensibly	http://www.crosswordgiant.com/crossword-clue/735522/Everyones-ancestor-ostensibly
Singer Lambert, runner-up on the 2009 'American Idol'	http://www.crosswordgiant.com/crossword-clue/735960/Singer-Lambert-runner-up-on-the-2009-American-Idol
Eve's mate	http://www.crosswordgiant.com/crossword-clue/746746/Eves-mate
Fictional inspector Dalgliesh	http://www.crosswordgiant.com/crossword-clue/747800/Fictional-inspector-Dalgliesh
Dunn of the Nats	http://www.crosswordgiant.com/crossword-clue/747801/Dunn-of-the-Nats
West of Gotham City	http://www.crosswordgiant.com/crossword-clue/755176/West-of-Gotham-City
Eden gardener	http://www.crosswordgiant.com/crossword-clue/758430/Eden-gardener
One cast out of paradise	http://www.crosswordgiant.com/crossword-clue/760477/One-cast-out-of-paradise
Partner of 49-Across	http://www.crosswordgiant.com/crossword-clue/762059/Partner-of-49-Across
63-Across's father	http://www.crosswordgiant.com/crossword-clue/768024/63-Acrosss-father
First rib donor?	http://www.crosswordgiant.com/crossword-clue/775136/First-rib-donor
Garden of Eden guy	http://www.crosswordgiant.com/crossword-clue/781526/Garden-of-Eden-guy
Loser of a rib	http://www.crosswordgiant.com/crossword-clue/790556/Loser-of-a-rib
Ant or West	http://www.crosswordgiant.com/crossword-clue/803306/Ant-or-West
''As You Like It'' servant	http://www.crosswordgiant.com/crossword-clue/809390/As-You-Like-It-servant
Partner of 109-Down	http://www.crosswordgiant.com/crossword-clue/811475/Partner-of-109-Down
Sandler of "Happy Gilmore"	http://www.crosswordgiant.com/crossword-clue/812314/Sandler-of-Happy-Gilmore
"The Wealth of Nations" author Smith	http://www.crosswordgiant.com/crossword-clue/816030/The-Wealth-of-Nations-author-Smith
Ant or Arkin	http://www.crosswordgiant.com/crossword-clue/817449/Ant-or-Arkin
Cain's father	http://www.crosswordgiant.com/crossword-clue/817788/Cains-father
The number one guy?	http://www.crosswordgiant.com/crossword-clue/818703/The-number-one-guy
33-Across's partner	http://www.crosswordgiant.com/crossword-clue/823667/33-Acrosss-partner
15-Across's dad	http://www.crosswordgiant.com/crossword-clue/837887/15-Acrosss-dad
West of Gotham City?	http://www.crosswordgiant.com/crossword-clue/839774/West-of-Gotham-City
Man without a mother	http://www.crosswordgiant.com/crossword-clue/840007/Man-without-a-mother
Eve's mate	http://www.crosswordgiant.com/crossword-clue/841062/Eves-mate
Father of 61-Across	http://www.crosswordgiant.com/crossword-clue/843090/Father-of-61-Across
Primal man?	http://www.crosswordgiant.com/crossword-clue/850827/Primal-man
First one here	http://www.crosswordgiant.com/crossword-clue/852049/First-one-here
One of the first people	http://www.crosswordgiant.com/crossword-clue/859607/One-of-the-first-people
Mate of 33-Across	http://www.crosswordgiant.com/crossword-clue/864493/Mate-of-33-Across
Brother on "Bonanza"	http://www.crosswordgiant.com/crossword-clue/867816/Brother-on-Bonanza
Eve's partner	http://www.crosswordgiant.com/crossword-clue/867995/Eves-partner
Eve's husband	http://www.crosswordgiant.com/crossword-clue/868040/Eves-husband
Place kicker Vinatieri with four Super Bowl rings	http://www.crosswordgiant.com/crossword-clue/870905/Place-kicker-Vinatieri-with-four-Super-Bowl-rings
Sandler of "Big Daddy"	http://www.crosswordgiant.com/crossword-clue/874591/Sandler-of-Big-Daddy
He helped raise Cain	http://www.crosswordgiant.com/crossword-clue/875615/He-helped-raise-Cain
Smith who wrote The Theory of Moral Sentiments	http://www.crosswordgiant.com/crossword-clue/880067/Smith-who-wrote-The-Theory-of-Moral-Sentiments
Earth's first gardener?	http://www.crosswordgiant.com/crossword-clue/884950/Earths-first-gardener
"I don't know him from ___"	http://www.crosswordgiant.com/crossword-clue/891515/I-dont-know-him-from-___
Ben's oldest son on "Bonanza"	http://www.crosswordgiant.com/crossword-clue/897558/Bens-oldest-son-on-Bonanza
Place kicker Vinatieri	http://www.crosswordgiant.com/crossword-clue/898613/Place-kicker-Vinatieri
Genesis fall guy	http://www.crosswordgiant.com/crossword-clue/898834/Genesis-fall-guy
Man before men	http://www.crosswordgiant.com/crossword-clue/901118/Man-before-men
Cain's dad	http://www.crosswordgiant.com/crossword-clue/906090/Cains-dad
Book of Genesis character	http://www.crosswordgiant.com/crossword-clue/906645/Book-of-Genesis-character
Sandler of "The Longest Yard"	http://www.crosswordgiant.com/crossword-clue/906944/Sandler-of-The-Longest-Yard
____Van Koeverden (winner of kayak silver)	http://www.crosswordgiant.com/crossword-clue/907546/____Van-Koeverden-winner-of-kayak-silver
Eve's partner	http://www.crosswordgiant.com/crossword-clue/907584/Eves-partner
Eve's husband	http://www.crosswordgiant.com/crossword-clue/909391/Eves-husband
Dweller in 67 Across	http://www.crosswordgiant.com/crossword-clue/919605/Dweller-in-67-Across
"Paradise Lost" character	http://www.crosswordgiant.com/crossword-clue/922325/Paradise-Lost-character
To whom God said 'You are dust, and to dust you shall return'	http://www.crosswordgiant.com/crossword-clue/923307/To-whom-God-said-You-are-dust-and-to-dust-you-shall-return
Diarist in a Mark Twain story	http://www.crosswordgiant.com/crossword-clue/923657/Diarist-in-a-Mark-Twain-story
First Prophet of Islam	http://www.crosswordgiant.com/crossword-clue/926071/First-Prophet-of-Islam
Levine of 'The Voice'	http://www.crosswordgiant.com/crossword-clue/926911/Levine-of-The-Voice
Someone who could give a first-person account?	http://www.crosswordgiant.com/crossword-clue/932777/Someone-who-could-give-a-first-person-account
Sandler of "Spanglish"	http://www.crosswordgiant.com/crossword-clue/935919/Sandler-of-Spanglish
The first man	http://www.crosswordgiant.com/crossword-clue/951010/The-first-man
First fruit-eater	http://www.crosswordgiant.com/crossword-clue/958334/First-fruit-eater
Father of man	http://www.crosswordgiant.com/crossword-clue/962977/Father-of-man
The first ancestor	http://www.crosswordgiant.com/crossword-clue/1014648/The-first-ancestor
6-Down's mate	http://www.crosswordgiant.com/crossword-clue/1019356/6-Downs-mate
Very early 2-Down	http://www.crosswordgiant.com/crossword-clue/1019452/Very-early-2-Down
First Christian ancestor	http://www.crosswordgiant.com/crossword-clue/1020408/First-Christian-ancestor
The first known ancestor	http://www.crosswordgiant.com/crossword-clue/1025760/The-first-known-ancestor
According to the Bible, the progenitor of the human race	http://www.crosswordgiant.com/crossword-clue/1041721/According-to-the-Bible-the-progenitor-of-the-human-race
One mother that's a father at first	http://www.crosswordgiant.com/crossword-clue/1046672/One-mother-thats-a-father-at-first
Father - or mother?	http://www.crosswordgiant.com/crossword-clue/1049411/Father-or-mother
Give the crafts a bit of no-go, perhaps, if one wants to get them going again	http://www.crosswordgiant.com/crossword-clue/1054794/Give-the-crafts-a-bit-of-no-go-perhaps-if-one-wants-to-get-them-going-again
Mother? No, Father	http://www.crosswordgiant.com/crossword-clue/1059298/Mother-No-Father
A father and mother	http://www.crosswordgiant.com/crossword-clue/1065088/A-father-and-mother
A 35 across turn for the gardener that got the sack	http://www.crosswordgiant.com/crossword-clue/1065215/A-35-across-turn-for-the-gardener-that-got-the-sack
The sort of ant that he might make inflexible	http://www.crosswordgiant.com/crossword-clue/1066597/The-sort-of-ant-that-he-might-make-inflexible
It takes an ant to make him firm	http://www.crosswordgiant.com/crossword-clue/1071601/It-takes-an-ant-to-make-him-firm
The sire that doesn't seem like one	http://www.crosswordgiant.com/crossword-clue/1075078/The-sire-that-doesnt-seem-like-one
Never had a mother - that's what he was	http://www.crosswordgiant.com/crossword-clue/1084467/Never-had-a-mother-thats-what-he-was
Motherly man?	http://www.crosswordgiant.com/crossword-clue/1086644/Motherly-man
Father came back for mother and father	http://www.crosswordgiant.com/crossword-clue/1087409/Father-came-back-for-mother-and-father
Mother? Never!	http://www.crosswordgiant.com/crossword-clue/1092941/Mother-Never
The first to put a stop to Mother, he is	http://www.crosswordgiant.com/crossword-clue/1106865/The-first-to-put-a-stop-to-Mother-he-is
Was he the first to get to 10 across?	http://www.crosswordgiant.com/crossword-clue/1109389/Was-he-the-first-to-get-to-10-across
The first man not to have a mother like this	http://www.crosswordgiant.com/crossword-clue/1113802/The-first-man-not-to-have-a-mother-like-this
Father that's Mother there in 15 across	http://www.crosswordgiant.com/crossword-clue/1135713/Father-thats-Mother-there-in-15-across
Your Ma? No, your Da	http://www.crosswordgiant.com/crossword-clue/1151294/Your-Ma-No-your-Da
'A mother? No, a father (4)'	http://www.crosswordgiant.com/crossword-clue/1172931/A-mother-No-a-father-4
Man without parents	http://www.crosswordgiant.com/crossword-clue/1191700/Man-without-parents
Man who's first in line?	http://www.crosswordgiant.com/crossword-clue/1192390/Man-whos-first-in-line
West of "Batman"	http://www.crosswordgiant.com/crossword-clue/1195572/West-of-Batman
Genesis gent	http://www.crosswordgiant.com/crossword-clue/1196097/Genesis-gent
Seth's father	http://www.crosswordgiant.com/crossword-clue/1196414/Seths-father
22 Across dweller	http://www.crosswordgiant.com/crossword-clue/1201737/22-Across-dweller
Genesis 2 name	http://www.crosswordgiant.com/crossword-clue/1208483/Genesis-2-name
"The Wedding Singer" star Sandler	http://www.crosswordgiant.com/crossword-clue/1212911/The-Wedding-Singer-star-Sandler
Sandler of "Grown Ups"	http://www.crosswordgiant.com/crossword-clue/1219166/Sandler-of-Grown-Ups
Founding father?	http://www.crosswordgiant.com/crossword-clue/1223469/Founding-father
Original donor	http://www.crosswordgiant.com/crossword-clue/1230300/Original-donor
Someone with a first-person account?	http://www.crosswordgiant.com/crossword-clue/1231249/Someone-with-a-first-person-account
First, Father gets a barrier	http://www.crosswordgiant.com/crossword-clue/1233150/First-Father-gets-a-barrier
A barrier first of all?	http://www.crosswordgiant.com/crossword-clue/1235619/A-barrier-first-of-all
___ and Steve (variation on a biblical pair)	http://www.crosswordgiant.com/crossword-clue/1236181/___-and-Steve-variation-on-a-biblical-pair
Australian golfer __ Scott	http://www.crosswordgiant.com/crossword-clue/1241511/Australian-golfer-__-Scott
... and his dad	http://www.crosswordgiant.com/crossword-clue/1244738/...-and-his-dad
Noted rib donor	http://www.crosswordgiant.com/crossword-clue/1247076/Noted-rib-donor
A mother for the first orphan?	http://www.crosswordgiant.com/crossword-clue/1264816/A-mother-for-the-first-orphan
First man to be a mother	http://www.crosswordgiant.com/crossword-clue/1282065/First-man-to-be-a-mother
A mother for a motherless man	http://www.crosswordgiant.com/crossword-clue/1282998/A-mother-for-a-motherless-man
A mother provided for one who lacked one	http://www.crosswordgiant.com/crossword-clue/1285149/A-mother-provided-for-one-who-lacked-one
Female married the first man to appear	http://www.crosswordgiant.com/crossword-clue/1285558/Female-married-the-first-man-to-appear
Man taking part had a magnificent physique	http://www.crosswordgiant.com/crossword-clue/1288531/Man-taking-part-had-a-magnificent-physique
He designed a water container	http://www.crosswordgiant.com/crossword-clue/1289851/He-designed-a-water-container
Early male requires a mother	http://www.crosswordgiant.com/crossword-clue/1291750/Early-male-requires-a-mother
A girl married him	http://www.crosswordgiant.com/crossword-clue/1297630/A-girl-married-him
A mother for one who was motherless	http://www.crosswordgiant.com/crossword-clue/1308166/A-mother-for-one-who-was-motherless
Resident of Paradise Avenue's westernmost block	http://www.crosswordgiant.com/crossword-clue/1311875/Resident-of-Paradise-Avenues-westernmost-block
Credit the pair who came first?	http://www.crosswordgiant.com/crossword-clue/1315681/Credit-the-pair-who-came-first
A crazy, upwardly-mobile architect	http://www.crosswordgiant.com/crossword-clue/1341721/A-crazy-upwardly-mobile-architect
Early man	http://www.crosswordgiant.com/crossword-clue/1350489/Early-man
One of our common ancestors?	http://www.crosswordgiant.com/crossword-clue/1355538/One-of-our-common-ancestors
First man in the Bible	http://www.crosswordgiant.com/crossword-clue/1378596/First-man-in-the-Bible
Biblical progenitor of human race	http://www.crosswordgiant.com/crossword-clue/1379573/Biblical-progenitor-of-human-race
First mother to first father	http://www.crosswordgiant.com/crossword-clue/1403849/First-mother-to-first-father
Sistine Chapel chap	http://www.crosswordgiant.com/crossword-clue/1421150/Sistine-Chapel-chap
He has an apple named after him?	http://www.crosswordgiant.com/crossword-clue/1423066/He-has-an-apple-named-after-him
First of its kind?	http://www.crosswordgiant.com/crossword-clue/1437927/First-of-its-kind
Genesis father of three	http://www.crosswordgiant.com/crossword-clue/1438629/Genesis-father-of-three
First given name in the Bible	http://www.crosswordgiant.com/crossword-clue/1442909/First-given-name-in-the-Bible
Sandler of comedy	http://www.crosswordgiant.com/crossword-clue/1447653/Sandler-of-comedy
Scott of 'Parks and Recreation' [The AV Club goes subscription only soon! Sign up at avxword.com]	http://www.crosswordgiant.com/crossword-clue/1460325/Scott-of-Parks-and-Recreation-The-AV-Club-goes-subscription-only-soon-Sign-up-at-avxword.com
'___ / Had 'em' (classic two-line poem about fleas)	http://www.crosswordgiant.com/crossword-clue/1468610/___-Had-em-classic-two-line-poem-about-fleas
West who played Batman	http://www.crosswordgiant.com/crossword-clue/1468940/West-who-played-Batman
First person with Borges leaves board games	http://www.crosswordgiant.com/crossword-clue/1477514/First-person-with-Borges-leaves-board-games
"Batman" star West	http://www.crosswordgiant.com/crossword-clue/1493961/Batman-star-West
Pop singer Lambert	http://www.crosswordgiant.com/crossword-clue/1494766/Pop-singer-Lambert
___ Yauch (real name of 24-Across)	http://www.crosswordgiant.com/crossword-clue/1496283/___-Yauch-real-name-of-24-Across
Economics pioneer Smith	http://www.crosswordgiant.com/crossword-clue/1498745/Economics-pioneer-Smith
Man on the ceiling of the Sistine Chapel	http://www.crosswordgiant.com/crossword-clue/1501823/Man-on-the-ceiling-of-the-Sistine-Chapel
