Put away	crosswordtracker.com/clue/put-away/
Frost	crosswordtracker.com/clue/frost/
Summer cooler	crosswordtracker.com/clue/summer-cooler/
Hotel freebie	crosswordtracker.com/clue/hotel-freebie/
Secure	crosswordtracker.com/clue/secure/
Cryophobe's fear	crosswordtracker.com/clue/cryophobes-fear/
Lock up	crosswordtracker.com/clue/lock-up-4/
Knock off	crosswordtracker.com/clue/knock-off/
Driving hazard	crosswordtracker.com/clue/driving-hazard/
Winter coat	crosswordtracker.com/clue/winter-coat/
Chill	crosswordtracker.com/clue/chill/
Cinch	crosswordtracker.com/clue/cinch/
Do away with	crosswordtracker.com/clue/do-away-with/
Bump off	crosswordtracker.com/clue/bump-off/
Whack	crosswordtracker.com/clue/whack/
Cooler	crosswordtracker.com/clue/cooler/
Clinch	crosswordtracker.com/clue/clinch/
Sew up	crosswordtracker.com/clue/sew-up/
Hotel amenity	crosswordtracker.com/clue/hotel-amenity-2/
Curling surface	crosswordtracker.com/clue/curling-surface/
Winter coat?	crosswordtracker.com/clue/winter-coat-1/
Bar supply	crosswordtracker.com/clue/bar-supply/
Freeze	crosswordtracker.com/clue/freeze/
Winter hazard	crosswordtracker.com/clue/winter-hazard/
Water cooler	crosswordtracker.com/clue/water-cooler/
Rocks	crosswordtracker.com/clue/rocks/
"Rhyme Pays" rapper	crosswordtracker.com/clue/rhyme-pays-rapper/
Bar staple	crosswordtracker.com/clue/bar-staple/
Swelling reducer	crosswordtracker.com/clue/swelling-reducer/
Winter driving hazard	crosswordtracker.com/clue/winter-driving-hazard/
Rocks at the bar	crosswordtracker.com/clue/rocks-at-the-bar/
Bartender's supply	crosswordtracker.com/clue/bartenders-supply/
Diamonds, in slang	crosswordtracker.com/clue/diamonds-in-slang/
Summer treat	crosswordtracker.com/clue/summer-treat-1/
Rink surface	crosswordtracker.com/clue/rink-surface/
Bar stock	crosswordtracker.com/clue/bar-stock/
Water cooler?	crosswordtracker.com/clue/water-cooler-1/
Type of tray	crosswordtracker.com/clue/type-of-tray/
Sculpting medium	crosswordtracker.com/clue/sculpting-medium/
Skating surface	crosswordtracker.com/clue/skating-surface/
Kind of beer	crosswordtracker.com/clue/kind-of-beer/
Diamonds, slangily	crosswordtracker.com/clue/diamonds-slangily/
Diamonds	crosswordtracker.com/clue/diamonds-33/
Sheet material	crosswordtracker.com/clue/sheet-material/
Food preserver	crosswordtracker.com/clue/food-preserver/
Frozen water	crosswordtracker.com/clue/frozen-water/
Cap material?	crosswordtracker.com/clue/cap-material/
Hard water?	crosswordtracker.com/clue/hard-water/
Piña colada ingredient	crosswordtracker.com/clue/pina-colada-ingredient/
"Rocks"	crosswordtracker.com/clue/rocks-61/
Road hazard	crosswordtracker.com/clue/road-hazard-2/
Frozen cubes	crosswordtracker.com/clue/frozen-cubes/
You may break it with guests	crosswordtracker.com/clue/you-may-break-it-with-guests/
Motel freebie	crosswordtracker.com/clue/motel-freebie/
Hotel sign	crosswordtracker.com/clue/hotel-sign/
Hard rain	crosswordtracker.com/clue/hard-rain-1/
Nail down	crosswordtracker.com/clue/nail-down/
Drink cooler	crosswordtracker.com/clue/drink-cooler/
Substance scraped by a Zamboni	crosswordtracker.com/clue/substance-scraped-by-a-zamboni/
Hazard to navigation	crosswordtracker.com/clue/hazard-to-navigation/
Sculpture material	crosswordtracker.com/clue/sculpture-material-1/
Cola cooler	crosswordtracker.com/clue/cola-cooler/
Motel sign	crosswordtracker.com/clue/motel-sign/
Bar basic	crosswordtracker.com/clue/bar-basic/
Cooler cooler	crosswordtracker.com/clue/cooler-cooler/
It has a chilling effect	crosswordtracker.com/clue/it-has-a-chilling-effect/
What a game may break	crosswordtracker.com/clue/what-a-game-may-break/
Rocks in a bar	crosswordtracker.com/clue/rocks-in-a-bar-1/
Bar need	crosswordtracker.com/clue/bar-need/
Winter walking hazard	crosswordtracker.com/clue/winter-walking-hazard/
Italian ___	crosswordtracker.com/clue/italian-___/
Sculptor's medium	crosswordtracker.com/clue/sculptors-medium/
Coolness	crosswordtracker.com/clue/coolness-1/
Kind of cream	crosswordtracker.com/clue/kind-of-cream/
Put on hold	crosswordtracker.com/clue/put-on-hold/
Contents of some bags	crosswordtracker.com/clue/contents-of-some-bags/
Frappé	crosswordtracker.com/clue/frappe-2/
Diamonds, to hoods	crosswordtracker.com/clue/diamonds-to-hoods/
Word with pick or pack	crosswordtracker.com/clue/word-with-pick-or-pack/
Hockey surface	crosswordtracker.com/clue/hockey-surface/
Zamboni's surface	crosswordtracker.com/clue/zambonis-surface/
Wintry coating	crosswordtracker.com/clue/wintry-coating/
Rocks, to a bartender	crosswordtracker.com/clue/rocks-to-a-bartender/
Slippery stuff	crosswordtracker.com/clue/slippery-stuff/
Swelling soother	crosswordtracker.com/clue/swelling-soother/
Rock salt may be used on it	crosswordtracker.com/clue/rock-salt-may-be-used-on-it/
Rocks in a glass	crosswordtracker.com/clue/rocks-in-a-glass/
Driving danger	crosswordtracker.com/clue/driving-danger/
Make sure of	crosswordtracker.com/clue/make-sure-of/
Frappé need	crosswordtracker.com/clue/frappe-need/
Bartender's rocks	crosswordtracker.com/clue/bartenders-rocks/
Sprain treatment	crosswordtracker.com/clue/sprain-treatment/
Party supply	crosswordtracker.com/clue/party-supply/
Sculpture material, sometimes	crosswordtracker.com/clue/sculpture-material-sometimes/
Hockey milieu	crosswordtracker.com/clue/hockey-milieu/
Temporary sculpture medium	crosswordtracker.com/clue/temporary-sculpture-medium/
Bar rocks	crosswordtracker.com/clue/bar-rocks/
It clinks in drinks	crosswordtracker.com/clue/it-clinks-in-drinks/
Slippery surface	crosswordtracker.com/clue/slippery-surface/
Skater's surface	crosswordtracker.com/clue/skaters-surface/
Hard water	crosswordtracker.com/clue/hard-water-1/
Make absolutely sure	crosswordtracker.com/clue/make-absolutely-sure/
Party purchase	crosswordtracker.com/clue/party-purchase/
It's cold, regardless of climate	crosswordtracker.com/clue/its-cold-regardless-of-climate/
Berg composition	crosswordtracker.com/clue/berg-composition/
Hot diamonds	crosswordtracker.com/clue/hot-diamonds/
Cause of skidding	crosswordtracker.com/clue/cause-of-skidding/
Cooler cubes	crosswordtracker.com/clue/cooler-cubes/
Hail, e.g.	crosswordtracker.com/clue/hail-eg/
Barkeep's supply	crosswordtracker.com/clue/barkeeps-supply/
Lemieux milieu	crosswordtracker.com/clue/lemieux-milieu/
Zamboni milieu	crosswordtracker.com/clue/zamboni-milieu/
Composition of some sheets	crosswordtracker.com/clue/composition-of-some-sheets/
Clinch, as a deal	crosswordtracker.com/clue/clinch-as-a-deal/
Polar formation	crosswordtracker.com/clue/polar-formation/
Bartender's need	crosswordtracker.com/clue/bartenders-need/
Diamonds, to Legs	crosswordtracker.com/clue/diamonds-to-legs/
Glaciate	crosswordtracker.com/clue/glaciate-3/
Sparklers	crosswordtracker.com/clue/sparklers/
Smoothie ingredient	crosswordtracker.com/clue/smoothie-ingredient-1/
Tend to a sprain	crosswordtracker.com/clue/tend-to-a-sprain/
Black ____	crosswordtracker.com/clue/black-____-1/
Bar necessity	crosswordtracker.com/clue/bar-necessity/
Decorate a cake	crosswordtracker.com/clue/decorate-a-cake/
Water one can walk on	crosswordtracker.com/clue/water-one-can-walk-on/
Type of chest	crosswordtracker.com/clue/type-of-chest/
Zamboni's place	crosswordtracker.com/clue/zambonis-place/
Diamonds, to a gangster	crosswordtracker.com/clue/diamonds-to-a-gangster/
A camel may be executed on it	crosswordtracker.com/clue/a-camel-may-be-executed-on-it/
It may be in blocks	crosswordtracker.com/clue/it-may-be-in-blocks/
Diamonds, to yeggs	crosswordtracker.com/clue/diamonds-to-yeggs/
Cubes in a bucket	crosswordtracker.com/clue/cubes-in-a-bucket/
Treat, as a sprain	crosswordtracker.com/clue/treat-as-a-sprain/
Injury soother	crosswordtracker.com/clue/injury-soother/
Glacier composition	crosswordtracker.com/clue/glacier-composition/
Rocks in bars	crosswordtracker.com/clue/rocks-in-bars/
Cooler in the cooler	crosswordtracker.com/clue/cooler-in-the-cooler/
Kind of jam	crosswordtracker.com/clue/kind-of-jam/
Word in the center of all three long entries	crosswordtracker.com/clue/word-in-the-center-of-all-three-long-entries/
Diamonds, to a cat burglar	crosswordtracker.com/clue/diamonds-to-a-cat-burglar/
Winter peril	crosswordtracker.com/clue/winter-peril/
Restaurant block	crosswordtracker.com/clue/restaurant-block/
Kwan's surface	crosswordtracker.com/clue/kwans-surface/
Sprain application	crosswordtracker.com/clue/sprain-application/
What chit-chat may break	crosswordtracker.com/clue/what-chit-chat-may-break/
It's sometimes sold in bags	crosswordtracker.com/clue/its-sometimes-sold-in-bags/
What a joke may break	crosswordtracker.com/clue/what-a-joke-may-break/
Winter Olympics need	crosswordtracker.com/clue/winter-olympics-need/
Main component of Saturn's rings	crosswordtracker.com/clue/main-component-of-saturns-rings/
Swell remedy?	crosswordtracker.com/clue/swell-remedy/
Winter sidewalk hazard	crosswordtracker.com/clue/winter-sidewalk-hazard/
Cold cube	crosswordtracker.com/clue/cold-cube/
Cool stuff	crosswordtracker.com/clue/cool-stuff/
Arctic surface	crosswordtracker.com/clue/arctic-surface/
Sno-cone filler	crosswordtracker.com/clue/sno-cone-filler/
Preserve, perhaps	crosswordtracker.com/clue/preserve-perhaps/
Sculpting material, sometimes	crosswordtracker.com/clue/sculpting-material-sometimes/
Curling setting	crosswordtracker.com/clue/curling-setting/
Type of cube or chest	crosswordtracker.com/clue/type-of-cube-or-chest/
Cooler drink	crosswordtracker.com/clue/cooler-drink/
Word with pack or pick	crosswordtracker.com/clue/word-with-pack-or-pick/
Wintry buildup	crosswordtracker.com/clue/wintry-buildup/
Yegg's haul	crosswordtracker.com/clue/yeggs-haul/
Bartender's "rocks"	crosswordtracker.com/clue/bartenders-rocks-1/
Some bling	crosswordtracker.com/clue/some-bling/
Winter sculpture medium	crosswordtracker.com/clue/winter-sculpture-medium/
Diamonds, to a yegg	crosswordtracker.com/clue/diamonds-to-a-yegg/
"Cool" target for a yegg?	crosswordtracker.com/clue/cool-target-for-a-yegg/
It's hard to walk on	crosswordtracker.com/clue/its-hard-to-walk-on/
Cool off	crosswordtracker.com/clue/cool-off-6/
Yegg's diamonds	crosswordtracker.com/clue/yeggs-diamonds/
Clinch, in slang	crosswordtracker.com/clue/clinch-in-slang/
Winter road hazard	crosswordtracker.com/clue/winter-road-hazard-1/
Knock off, to a mobster	crosswordtracker.com/clue/knock-off-to-a-mobster/
Shelf material	crosswordtracker.com/clue/shelf-material/
It may be crushed	crosswordtracker.com/clue/it-may-be-crushed/
Cover at the bakery	crosswordtracker.com/clue/cover-at-the-bakery/
Vanilla ___	crosswordtracker.com/clue/vanilla-___/
What makes a drink clink	crosswordtracker.com/clue/what-makes-a-drink-clink/
Dry __	crosswordtracker.com/clue/dry-__/
Frost a cake	crosswordtracker.com/clue/frost-a-cake/
Surface for a Sabre	crosswordtracker.com/clue/surface-for-a-sabre/
More than aloofness	crosswordtracker.com/clue/more-than-aloofness/
Ferber's "___ Palace"	crosswordtracker.com/clue/ferbers-___-palace/
Cooler for coolers	crosswordtracker.com/clue/cooler-for-coolers/
Cooler filler	crosswordtracker.com/clue/cooler-filler/
Cold cubes	crosswordtracker.com/clue/cold-cubes-1/
Home ___ (hockey advantage)	crosswordtracker.com/clue/home-___-hockey-advantage/
Rocks in a tumbler	crosswordtracker.com/clue/rocks-in-a-tumbler/
Word in many beer names	crosswordtracker.com/clue/word-in-many-beer-names/
Rocks, in a bar	crosswordtracker.com/clue/rocks-in-a-bar-2/
Misplay a puck	crosswordtracker.com/clue/misplay-a-puck/
____Mountain, British Columbia	crosswordtracker.com/clue/____mountain-british-columbia/
Hockey prerequisite	crosswordtracker.com/clue/hockey-prerequisite/
Black______	crosswordtracker.com/clue/black______/
Off, in a way	crosswordtracker.com/clue/off-in-a-way/
Crystal	crosswordtracker.com/clue/crystal-66/
Word with cap or cube	crosswordtracker.com/clue/word-with-cap-or-cube/
Bucket type	crosswordtracker.com/clue/bucket-type/
Some cubes	crosswordtracker.com/clue/some-cubes/
Makeup of some sheets	crosswordtracker.com/clue/makeup-of-some-sheets/
Screwdriver part	crosswordtracker.com/clue/screwdriver-part-1/
Kill, in mob slang	crosswordtracker.com/clue/kill-in-mob-slang/
Cube or cream preceder	crosswordtracker.com/clue/cube-or-cream-preceder/
Cubes in a bar	crosswordtracker.com/clue/cubes-in-a-bar/
Jewelry, to R. Kelly	crosswordtracker.com/clue/jewelry-to-r-kelly/
Skid cause	crosswordtracker.com/clue/skid-cause/
Jewelry or meth, in slang	crosswordtracker.com/clue/jewelry-or-meth-in-slang/
Seal, as a victory	crosswordtracker.com/clue/seal-as-a-victory/
Jewelry	crosswordtracker.com/clue/jewelry-50/
Some people like their espresso poured over it	crosswordtracker.com/clue/some-people-like-their-espresso-poured-over-it/
Winter walking peril	crosswordtracker.com/clue/winter-walking-peril/
Diamonds, as it were	crosswordtracker.com/clue/diamonds-as-it-were/
Coco's co-star	crosswordtracker.com/clue/cocos-co-star/
Surface for Sharks	crosswordtracker.com/clue/surface-for-sharks/
Bucket filler	crosswordtracker.com/clue/bucket-filler/
Rocks in the freezer	crosswordtracker.com/clue/rocks-in-the-freezer/
Glacial material	crosswordtracker.com/clue/glacial-material/
Arctic landscape	crosswordtracker.com/clue/arctic-landscape/
Age that came with a chill	crosswordtracker.com/clue/age-that-came-with-a-chill/
Machine in a motel	crosswordtracker.com/clue/machine-in-a-motel/
Skier's bane	crosswordtracker.com/clue/skiers-bane/
NHL surface	crosswordtracker.com/clue/nhl-surface/
Diamonds, to a fence	crosswordtracker.com/clue/diamonds-to-a-fence/
Alternative in a Frost poem	crosswordtracker.com/clue/alternative-in-a-frost-poem/
Cubes in a freezer	crosswordtracker.com/clue/cubes-in-a-freezer/
Sheet on the road, perhaps	crosswordtracker.com/clue/sheet-on-the-road-perhaps/
Requirement for curlers	crosswordtracker.com/clue/requirement-for-curlers/
Old pushcart cry	crosswordtracker.com/clue/old-pushcart-cry/
Cold blocks	crosswordtracker.com/clue/cold-blocks/
Gretzky's stage	crosswordtracker.com/clue/gretzkys-stage/
Freezer item	crosswordtracker.com/clue/freezer-item/
Crook's diamonds	crosswordtracker.com/clue/crooks-diamonds/
Chilly cubes	crosswordtracker.com/clue/chilly-cubes/
Olympic dancing venue	crosswordtracker.com/clue/olympic-dancing-venue/
Windshield annoyance	crosswordtracker.com/clue/windshield-annoyance/
Windshield inconvenience	crosswordtracker.com/clue/windshield-inconvenience/
Rocks in a cocktail	crosswordtracker.com/clue/rocks-in-a-cocktail/
Drink coolant	crosswordtracker.com/clue/drink-coolant/
Rocks, maybe	crosswordtracker.com/clue/rocks-maybe/
It may be found in a sheet	crosswordtracker.com/clue/it-may-be-found-in-a-sheet/
Pack or pick preceder	crosswordtracker.com/clue/pack-or-pick-preceder/
Block in a restaurant?	crosswordtracker.com/clue/block-in-a-restaurant/
Water you may walk on	crosswordtracker.com/clue/water-you-may-walk-on/
It can be shaved or cracked	crosswordtracker.com/clue/it-can-be-shaved-or-cracked/
Rocks in a bar?	crosswordtracker.com/clue/rocks-in-a-bar/
Cube-shaped rocks?	crosswordtracker.com/clue/cube-shaped-rocks/
Word with cap or cream	crosswordtracker.com/clue/word-with-cap-or-cream/
Shelf component, perhaps	crosswordtracker.com/clue/shelf-component-perhaps/
Wintry covering	crosswordtracker.com/clue/wintry-covering/
Rocks from a bucket	crosswordtracker.com/clue/rocks-from-a-bucket/
Bruise treatment	crosswordtracker.com/clue/bruise-treatment/
Sprain remedy	crosswordtracker.com/clue/sprain-remedy/
Bucket or pack filler	crosswordtracker.com/clue/bucket-or-pack-filler/
Word after pack or black	crosswordtracker.com/clue/word-after-pack-or-black/
Chiller of a sort	crosswordtracker.com/clue/chiller-of-a-sort/
Word in several 4D monikers	crosswordtracker.com/clue/word-in-several-4d-monikers/
Word before beer or milk	crosswordtracker.com/clue/word-before-beer-or-milk/
Most of Greenland	crosswordtracker.com/clue/most-of-greenland/
Much of Saturn's rings	crosswordtracker.com/clue/much-of-saturns-rings/
Short-lived sculpture medium	crosswordtracker.com/clue/short-lived-sculpture-medium/
Winter blackout cause, often	crosswordtracker.com/clue/winter-blackout-cause-often/
Neat drink's lack	crosswordtracker.com/clue/neat-drinks-lack/
Mint julep ingredient	crosswordtracker.com/clue/mint-julep-ingredient/
Cocktail cooler	crosswordtracker.com/clue/cocktail-cooler/
Glacier substance	crosswordtracker.com/clue/glacier-substance/
Diamonds or rocks, in slang	crosswordtracker.com/clue/diamonds-or-rocks-in-slang/
Wine cooler?	crosswordtracker.com/clue/wine-cooler/
Dentyne brand name	crosswordtracker.com/clue/dentyne-brand-name/
Swell reducer	crosswordtracker.com/clue/swell-reducer/
Rocks, at the bar	crosswordtracker.com/clue/rocks-at-the-bar-1/
Primary component of Saturn's rings	crosswordtracker.com/clue/primary-component-of-saturns-rings/
Curler's setting	crosswordtracker.com/clue/curlers-setting/
Kind of pack or pick	crosswordtracker.com/clue/kind-of-pack-or-pick/
Diamonds, informally	crosswordtracker.com/clue/diamonds-informally/
It's sold in blocks	crosswordtracker.com/clue/its-sold-in-blocks/
Denverite's December driving danger	crosswordtracker.com/clue/denverites-december-driving-danger/
''Fire and ___'' by Robert Frost	crosswordtracker.com/clue/fire-and-___-by-robert-frost/
Certain sculpting medium	crosswordtracker.com/clue/certain-sculpting-medium/
''___ Station Zebra''	crosswordtracker.com/clue/___-station-zebra/
Hot stones	crosswordtracker.com/clue/hot-stones/
Chest contents, often	crosswordtracker.com/clue/chest-contents-often/
Word with ''maker'' or ''breaker''	crosswordtracker.com/clue/word-with-maker-or-breaker/
Chilling pieces?	crosswordtracker.com/clue/chilling-pieces/
Word with "skate" or "water"	crosswordtracker.com/clue/word-with-skate-or-water/
Zamboni's milieu	crosswordtracker.com/clue/zambonis-milieu/
Pepsi cooler	crosswordtracker.com/clue/pepsi-cooler/
"___ Station Zebra"	crosswordtracker.com/clue/___-station-zebra-1/
Word with "water" or "maker"	crosswordtracker.com/clue/word-with-water-or-maker/
Kind of fishing	crosswordtracker.com/clue/kind-of-fishing/
Diamonds, to a thief	crosswordtracker.com/clue/diamonds-to-a-thief/
___ Capades (skating show)	crosswordtracker.com/clue/___-capades-skating-show/
Something to push for in hotels	crosswordtracker.com/clue/something-to-push-for-in-hotels/
Rocks for a Black Russian	crosswordtracker.com/clue/rocks-for-a-black-russian/
Cool cubes	crosswordtracker.com/clue/cool-cubes/
It's sold in bags or blocks	crosswordtracker.com/clue/its-sold-in-bags-or-blocks/
Cruise sculptor's medium	crosswordtracker.com/clue/cruise-sculptors-medium/
Rocks, at a bar	crosswordtracker.com/clue/rocks-at-a-bar/
Surface for Kings and Senators	crosswordtracker.com/clue/surface-for-kings-and-senators/
Treatment for swelling	crosswordtracker.com/clue/treatment-for-swelling/
Rocks, to a barkeep	crosswordtracker.com/clue/rocks-to-a-barkeep/
Most of Antarctica	crosswordtracker.com/clue/most-of-antarctica/
Beverage-store bagful	crosswordtracker.com/clue/beverage-store-bagful/
Assure victory in, slangily	crosswordtracker.com/clue/assure-victory-in-slangily/
Manhattan cooler?	crosswordtracker.com/clue/manhattan-cooler/
Snow cone base	crosswordtracker.com/clue/snow-cone-base/
Word before bag or chest	crosswordtracker.com/clue/word-before-bag-or-chest/
Epitome of coldness	crosswordtracker.com/clue/epitome-of-coldness/
"March of the Penguins" milieu	crosswordtracker.com/clue/march-of-the-penguins-milieu/
Eldridge Cleaver's "Soul on __"	crosswordtracker.com/clue/eldridge-cleavers-soul-on-__/
Cubes from the freezer	crosswordtracker.com/clue/cubes-from-the-freezer/
Beverage store buy	crosswordtracker.com/clue/beverage-store-buy/
What most of hail is	crosswordtracker.com/clue/what-most-of-hail-is/
Number in a pack?	crosswordtracker.com/clue/number-in-a-pack/
Freezer cubes	crosswordtracker.com/clue/freezer-cubes/
It's never in a neat order	crosswordtracker.com/clue/its-never-in-a-neat-order/
Something with this is not neat	crosswordtracker.com/clue/something-with-this-is-not-neat/
Sno-cone base	crosswordtracker.com/clue/sno-cone-base/
Supermarket bagful	crosswordtracker.com/clue/supermarket-bagful/
Something to slip on	crosswordtracker.com/clue/something-to-slip-on-1/
Boardwalk treat	crosswordtracker.com/clue/boardwalk-treat/
Medium for playing the Blues?	crosswordtracker.com/clue/medium-for-playing-the-blues/
Freezer tray contents	crosswordtracker.com/clue/freezer-tray-contents/
Stuff in trays	crosswordtracker.com/clue/stuff-in-trays/
Freezer trayful	crosswordtracker.com/clue/freezer-trayful/
Word before maker or breaker	crosswordtracker.com/clue/word-before-maker-or-breaker/
Put away for good	crosswordtracker.com/clue/put-away-for-good/
Something found in a sheet	crosswordtracker.com/clue/something-found-in-a-sheet/
Party purchase, perhaps	crosswordtracker.com/clue/party-purchase-perhaps/
Zamboni surface	crosswordtracker.com/clue/zamboni-surface/
Freezer buildup	crosswordtracker.com/clue/freezer-buildup/
Slurpee substance	crosswordtracker.com/clue/slurpee-substance/
Hotel bucketful	crosswordtracker.com/clue/hotel-bucketful/
Floe material	crosswordtracker.com/clue/floe-material/
Plans may be put on it	crosswordtracker.com/clue/plans-may-be-put-on-it/
Party host's bagful	crosswordtracker.com/clue/party-hosts-bagful/
Arctic pier material	crosswordtracker.com/clue/arctic-pier-material/
Glacier, essentially	crosswordtracker.com/clue/glacier-essentially/
Blocks from the refrigerator	crosswordtracker.com/clue/blocks-from-the-refrigerator/
It's very cool	crosswordtracker.com/clue/its-very-cool/
Berg makeup	crosswordtracker.com/clue/berg-makeup/
Ship navigation hazard	crosswordtracker.com/clue/ship-navigation-hazard/
It's found in rinks and drinks	crosswordtracker.com/clue/its-found-in-rinks-and-drinks/
Nail down or cool down	crosswordtracker.com/clue/nail-down-or-cool-down/
Word before pack, pick, or the puck	crosswordtracker.com/clue/word-before-pack-pick-or-the-puck/
Curling venue	crosswordtracker.com/clue/curling-venue/
Clinch or cinch	crosswordtracker.com/clue/clinch-or-cinch/
Water, when it gets cold enough	crosswordtracker.com/clue/water-when-it-gets-cold-enough/
Cool sculpture medium	crosswordtracker.com/clue/cool-sculpture-medium/
Beverage cooler	crosswordtracker.com/clue/beverage-cooler/
Last-minute party purchase	crosswordtracker.com/clue/last-minute-party-purchase/
Winter glaze	crosswordtracker.com/clue/winter-glaze/
Word repeated before "Baby" in a hip-hop title	crosswordtracker.com/clue/word-repeated-before-baby-in-a-hip-hop-title/
Water at 31 degrees	crosswordtracker.com/clue/water-at-31-degrees/
Freezer stuff	crosswordtracker.com/clue/freezer-stuff/
Hotel floor sign	crosswordtracker.com/clue/hotel-floor-sign/
H20 at 0°	crosswordtracker.com/clue/h20-at-0/
Pilot's worry	crosswordtracker.com/clue/pilots-worry/
Chiller	crosswordtracker.com/clue/chiller-2/
Cause of a skid	crosswordtracker.com/clue/cause-of-a-skid/
Cap material	crosswordtracker.com/clue/cap-material-1/
___ cream	crosswordtracker.com/clue/___-cream-1/
Harbor problem	crosswordtracker.com/clue/harbor-problem/
Convenience store bagful	crosswordtracker.com/clue/convenience-store-bagful/
It's hard to get a grip on	crosswordtracker.com/clue/its-hard-to-get-a-grip-on/
Kind of beer or bag	crosswordtracker.com/clue/kind-of-beer-or-bag/
Eskimo building material	crosswordtracker.com/clue/eskimo-building-material/
Tundra feature	crosswordtracker.com/clue/tundra-feature/
Word with bag or cap	crosswordtracker.com/clue/word-with-bag-or-cap/
Diamonds, in criminal slang	crosswordtracker.com/clue/diamonds-in-criminal-slang/
Secure, as a victory	crosswordtracker.com/clue/secure-as-a-victory/
Make final	crosswordtracker.com/clue/make-final-2/
Broomball surface	crosswordtracker.com/clue/broomball-surface/
Kind of bag or chest	crosswordtracker.com/clue/kind-of-bag-or-chest/
Rocks, so to speak	crosswordtracker.com/clue/rocks-so-to-speak/
Break the ___	crosswordtracker.com/clue/break-the-___/
Christmas traveler's worry	crosswordtracker.com/clue/christmas-travelers-worry/
Type of tray or cube	crosswordtracker.com/clue/type-of-tray-or-cube/
Infant harp seal's surface	crosswordtracker.com/clue/infant-harp-seals-surface/
Cooler contents	crosswordtracker.com/clue/cooler-contents/
Rocks in glasses	crosswordtracker.com/clue/rocks-in-glasses/
Treat, as a bruise	crosswordtracker.com/clue/treat-as-a-bruise/
It makes a drink clink	crosswordtracker.com/clue/it-makes-a-drink-clink/
On ___ (in reserve)	crosswordtracker.com/clue/on-___-in-reserve/
Surface for a Flame	crosswordtracker.com/clue/surface-for-a-flame/
Hot gems	crosswordtracker.com/clue/hot-gems/
Surface for Gretzky	crosswordtracker.com/clue/surface-for-gretzky/
Hood's diamonds	crosswordtracker.com/clue/hoods-diamonds/
Trainer's aid, often	crosswordtracker.com/clue/trainers-aid-often/
Pleistocene Age	crosswordtracker.com/clue/pleistocene-age/
Frazil	crosswordtracker.com/clue/frazil/
Surface for Hamill	crosswordtracker.com/clue/surface-for-hamill/
Verglas ingredient	crosswordtracker.com/clue/verglas-ingredient/
Legs Diamond's diamonds	crosswordtracker.com/clue/legs-diamonds-diamonds/
Italian _____	crosswordtracker.com/clue/italian-_____/
Kind of cap or cream	crosswordtracker.com/clue/kind-of-cap-or-cream/
Treat a sprain	crosswordtracker.com/clue/treat-a-sprain/
The rocks in "on the rocks"	crosswordtracker.com/clue/the-rocks-in-on-the-rocks/
Murder, in mob talk	crosswordtracker.com/clue/murder-in-mob-talk/
Make sure of, as a victory	crosswordtracker.com/clue/make-sure-of-as-a-victory/
Tray material	crosswordtracker.com/clue/tray-material/
Sorbet	crosswordtracker.com/clue/sorbet-5/
Bump off, so to speak	crosswordtracker.com/clue/bump-off-so-to-speak/
_____ dancing	crosswordtracker.com/clue/_____-dancing/
Protection money, in slang	crosswordtracker.com/clue/protection-money-in-slang/
It goes with the floe	crosswordtracker.com/clue/it-goes-with-the-floe/
"Hot" gems	crosswordtracker.com/clue/hot-gems-1/
H2O, at times	crosswordtracker.com/clue/h2o-at-times/
Debi Thomas's milieu	crosswordtracker.com/clue/debi-thomass-milieu/
Moll's diamonds	crosswordtracker.com/clue/molls-diamonds/
Jewel thief's loot	crosswordtracker.com/clue/jewel-thiefs-loot/
Surface for Scott Hamilton	crosswordtracker.com/clue/surface-for-scott-hamilton/
Rocks, to a hood	crosswordtracker.com/clue/rocks-to-a-hood/
Frozen H2O	crosswordtracker.com/clue/frozen-h2o/
Diamonds, to a hood	crosswordtracker.com/clue/diamonds-to-a-hood/
Underfooting for Fleming	crosswordtracker.com/clue/underfooting-for-fleming/
Manhattan chiller	crosswordtracker.com/clue/manhattan-chiller/
Jan. 1 head-soother	crosswordtracker.com/clue/jan-1-head-soother/
Drink additive	crosswordtracker.com/clue/drink-additive-1/
Necessity for making mint juleps	crosswordtracker.com/clue/necessity-for-making-mint-juleps/
Its sold in bags	crosswordtracker.com/clue/its-sold-in-bags-1/
Dentyne breath-freshening gum	crosswordtracker.com/clue/dentyne-breath-freshening-gum/
Wedding sculpture material	crosswordtracker.com/clue/wedding-sculpture-material/
Assure	crosswordtracker.com/clue/assure-18/
It's sold in bags	crosswordtracker.com/clue/its-sold-in-bags-2/
Cube makeup	crosswordtracker.com/clue/cube-makeup/
Crystal meth, in slang	crosswordtracker.com/clue/crystal-meth-in-slang/
Profit made from scalping tickets	crosswordtracker.com/clue/profit-made-from-scalping-tickets/
Word with skater or water	crosswordtracker.com/clue/word-with-skater-or-water/
Salchow surface	crosswordtracker.com/clue/salchow-surface/
Word with fishing and dancing	crosswordtracker.com/clue/word-with-fishing-and-dancing/
___-nine (substance in "Cat's Cradle")	crosswordtracker.com/clue/___-nine-substance-in-cats-cradle/
Diamonds, in fencing slang	crosswordtracker.com/clue/diamonds-in-fencing-slang/
People often get checked while moving across it	crosswordtracker.com/clue/people-often-get-checked-while-moving-across-it/
Ephemeral sculpture medium	crosswordtracker.com/clue/ephemeral-sculpture-medium/
Berg's makeup	crosswordtracker.com/clue/bergs-makeup/
Wine cooler	crosswordtracker.com/clue/wine-cooler-1/
Word with pick or ax	crosswordtracker.com/clue/word-with-pick-or-ax/
Dancing surface, sometimes	crosswordtracker.com/clue/dancing-surface-sometimes/
Puck-carrier's surface	crosswordtracker.com/clue/puck-carriers-surface/
Substance for sculptures	crosswordtracker.com/clue/substance-for-sculptures/
Curling or hockey surface	crosswordtracker.com/clue/curling-or-hockey-surface/
Hockey  surface	crosswordtracker.com/clue/hockey-surface-1/
Finish a cake	crosswordtracker.com/clue/finish-a-cake/
Glacier feature	crosswordtracker.com/clue/glacier-feature/
Hockey or curling surface	crosswordtracker.com/clue/hockey-or-curling-surface/
Relieve the pressure, in a way	crosswordtracker.com/clue/relieve-the-pressure-in-a-way/
____cap	crosswordtracker.com/clue/____cap/
Dispose of, in a way	crosswordtracker.com/clue/dispose-of-in-a-way/
Curling sheet	crosswordtracker.com/clue/curling-sheet/
Misplay the puck	crosswordtracker.com/clue/misplay-the-puck/
Black ___ (winter highway hazard)	crosswordtracker.com/clue/black-___-winter-highway-hazard/
Cool stuff hidden in eight puzzle answers	crosswordtracker.com/clue/cool-stuff-hidden-in-eight-puzzle-answers/
Yamaguchi's milieu	crosswordtracker.com/clue/yamaguchis-milieu/
Sculpture medium	crosswordtracker.com/clue/sculpture-medium/
Jet hazard	crosswordtracker.com/clue/jet-hazard/
Undesirable wing coating	crosswordtracker.com/clue/undesirable-wing-coating/
Witt's surface	crosswordtracker.com/clue/witts-surface/
Gems, slangily	crosswordtracker.com/clue/gems-slangily/
Crunchable cubes	crosswordtracker.com/clue/crunchable-cubes/
Bling-bling component, often	crosswordtracker.com/clue/bling-bling-component-often/
Curling need	crosswordtracker.com/clue/curling-need/
It's run over by a Zamboni	crosswordtracker.com/clue/its-run-over-by-a-zamboni/
Boitano's surface	crosswordtracker.com/clue/boitanos-surface/
Type of tray or chest	crosswordtracker.com/clue/type-of-tray-or-chest/
Rocks, in a nightclub	crosswordtracker.com/clue/rocks-in-a-nightclub/
Rocks, to Isaac on "The Love Boat"	crosswordtracker.com/clue/rocks-to-isaac-on-the-love-boat/
Word with cap or pack	crosswordtracker.com/clue/word-with-cap-or-pack/
Word with hockey or bucket	crosswordtracker.com/clue/word-with-hockey-or-bucket/
Jewelry, to a yegg	crosswordtracker.com/clue/jewelry-to-a-yegg/
Rink medium	crosswordtracker.com/clue/rink-medium/
Kind of bag or axe	crosswordtracker.com/clue/kind-of-bag-or-axe/
H2O below 32 degrees	crosswordtracker.com/clue/h2o-below-32-degrees/
Creator of a slippery slope	crosswordtracker.com/clue/creator-of-a-slippery-slope/
Witt's milieu	crosswordtracker.com/clue/witts-milieu/
Water you can walk on	crosswordtracker.com/clue/water-you-can-walk-on/
Word with cream or box	crosswordtracker.com/clue/word-with-cream-or-box/
Mixer's frozen asset	crosswordtracker.com/clue/mixers-frozen-asset-1/
Vanilla of rap	crosswordtracker.com/clue/vanilla-of-rap/
Word with box or cream	crosswordtracker.com/clue/word-with-box-or-cream/
Mixer's asset	crosswordtracker.com/clue/mixers-asset/
Word with show or box	crosswordtracker.com/clue/word-with-show-or-box/
Word with tray or cube	crosswordtracker.com/clue/word-with-tray-or-cube/
Jewels, slangily	crosswordtracker.com/clue/jewels-slangily/
Fishmonger's need	crosswordtracker.com/clue/fishmongers-need/
Rocks at a bar	crosswordtracker.com/clue/rocks-at-a-bar-1/
Islanders' surface	crosswordtracker.com/clue/islanders-surface/
Bobsled run surface	crosswordtracker.com/clue/bobsled-run-surface/
It'll melt in your mouth	crosswordtracker.com/clue/itll-melt-in-your-mouth/
Dentyne brand	crosswordtracker.com/clue/dentyne-brand-1/
Ephemeral sculpting medium	crosswordtracker.com/clue/ephemeral-sculpting-medium/
Rink floor	crosswordtracker.com/clue/rink-floor/
Soda cooler	crosswordtracker.com/clue/soda-cooler/
It may be shaved	crosswordtracker.com/clue/it-may-be-shaved/
Chains et al.	crosswordtracker.com/clue/chains-et-al/
Meth, slangily	crosswordtracker.com/clue/meth-slangily/
It keeps things from being neat	crosswordtracker.com/clue/it-keeps-things-from-being-neat/
Force to drink a disgusting Smirnoff beverage, in bro-speak	crosswordtracker.com/clue/force-to-drink-a-disgusting-smirnoff-beverage-in-bro-speak/
Trump ___ (defunct bottled water brand)	crosswordtracker.com/clue/trump-___-defunct-bottled-water-brand/
Scotch dilutant	crosswordtracker.com/clue/scotch-dilutant/
Something brushed in a curling game	crosswordtracker.com/clue/something-brushed-in-a-curling-game/
Rocks for a White Russian	crosswordtracker.com/clue/rocks-for-a-white-russian/
Lemieux milieu	http://www.crosswordgiant.com/crossword-clue/221168/Lemieux-milieu
Frozen water	http://www.crosswordgiant.com/crossword-clue/496676/Frozen-water
'Rocks'	http://www.crosswordgiant.com/crossword-clue/28188/Rocks
Rink surface	http://www.crosswordgiant.com/crossword-clue/40761/Rink-surface
Skating surface	http://www.crosswordgiant.com/crossword-clue/1229/Skating-surface
Water cooler	http://www.crosswordgiant.com/crossword-clue/35318/Water-cooler
Drink cooler	http://www.crosswordgiant.com/crossword-clue/248162/Drink-cooler
Hockey surface	http://www.crosswordgiant.com/crossword-clue/408508/Hockey-surface
Bar supply	http://www.crosswordgiant.com/crossword-clue/186068/Bar-supply
Diamonds	http://www.crosswordgiant.com/crossword-clue/8103/Diamonds
Rocks	http://www.crosswordgiant.com/crossword-clue/64530/Rocks
Curling surface	http://www.crosswordgiant.com/crossword-clue/113588/Curling-surface
Hotel freebie	http://www.crosswordgiant.com/crossword-clue/81436/Hotel-freebie
Decorate a cake	http://www.crosswordgiant.com/crossword-clue/597881/Decorate-a-cake
Glacier makeup	http://www.crosswordgiant.com/crossword-clue/243213/Glacier-makeup
Sew up	http://www.crosswordgiant.com/crossword-clue/57614/Sew-up
Bar need	http://www.crosswordgiant.com/crossword-clue/70412/Bar-need
Motel freebie	http://www.crosswordgiant.com/crossword-clue/245288/Motel-freebie
Drink cubes	http://www.crosswordgiant.com/crossword-clue/261586/Drink-cubes
Rocks at the bar	http://www.crosswordgiant.com/crossword-clue/271314/Rocks-at-the-bar
Cap material?	http://www.crosswordgiant.com/crossword-clue/48550/Cap-material
Hard water?	http://www.crosswordgiant.com/crossword-clue/127405/Hard-water
Rink material	http://www.crosswordgiant.com/crossword-clue/218688/Rink-material
Julep need	http://www.crosswordgiant.com/crossword-clue/349720/Julep-need
Put away	http://www.crosswordgiant.com/crossword-clue/14376/Put-away
Hotel sign	http://www.crosswordgiant.com/crossword-clue/16392/Hotel-sign
Swelling reducer	http://www.crosswordgiant.com/crossword-clue/123805/Swelling-reducer
Bar cubes	http://www.crosswordgiant.com/crossword-clue/406078/Bar-cubes
Clinch	http://www.crosswordgiant.com/crossword-clue/6687/Clinch
Sculpting medium	http://www.crosswordgiant.com/crossword-clue/79074/Sculpting-medium
Food preserver	http://www.crosswordgiant.com/crossword-clue/111707/Food-preserver
Road hazard	http://www.crosswordgiant.com/crossword-clue/188483/Road-hazard
Winter driving hazard	http://www.crosswordgiant.com/crossword-clue/64939/Winter-driving-hazard
Type of tray	http://www.crosswordgiant.com/crossword-clue/103458/Type-of-tray
It has a chilling effect	http://www.crosswordgiant.com/crossword-clue/108352/It-has-a-chilling-effect
Winter hazard	http://www.crosswordgiant.com/crossword-clue/124464/Winter-hazard
Diamonds, slangily	http://www.crosswordgiant.com/crossword-clue/163559/Diamonds-slangily
You may break it with guests	http://www.crosswordgiant.com/crossword-clue/169793/You-may-break-it-with-guests
Bar 'rocks'	http://www.crosswordgiant.com/crossword-clue/323023/Bar-rocks
Frozen cubes	http://www.crosswordgiant.com/crossword-clue/700859/Frozen-cubes
Driving hazard	http://www.crosswordgiant.com/crossword-clue/9545/Driving-hazard
Italian ___	http://www.crosswordgiant.com/crossword-clue/40943/Italian-___
Injury soother	http://www.crosswordgiant.com/crossword-clue/202742/Injury-soother
What a game may break	http://www.crosswordgiant.com/crossword-clue/244325/What-a-game-may-break
Rocks in a bar	http://www.crosswordgiant.com/crossword-clue/259415/Rocks-in-a-bar
Water cooler?	http://www.crosswordgiant.com/crossword-clue/309174/Water-cooler
Hockey venue	http://www.crosswordgiant.com/crossword-clue/404031/Hockey-venue
Tea cooler	http://www.crosswordgiant.com/crossword-clue/422264/Tea-cooler
Winter coat	http://www.crosswordgiant.com/crossword-clue/76826/Winter-coat
Winter coat?	http://www.crosswordgiant.com/crossword-clue/119520/Winter-coat
Cooler cooler	http://www.crosswordgiant.com/crossword-clue/149530/Cooler-cooler
Sculpture material	http://www.crosswordgiant.com/crossword-clue/194777/Sculpture-material
Word with pick or pack	http://www.crosswordgiant.com/crossword-clue/207216/Word-with-pick-or-pack
Cola cooler	http://www.crosswordgiant.com/crossword-clue/303595/Cola-cooler
Swelling soother	http://www.crosswordgiant.com/crossword-clue/346535/Swelling-soother
Winter walking hazard	http://www.crosswordgiant.com/crossword-clue/404476/Winter-walking-hazard
Party supply	http://www.crosswordgiant.com/crossword-clue/437966/Party-supply
Cold cubes	http://www.crosswordgiant.com/crossword-clue/464159/Cold-cubes
Frappe	http://www.crosswordgiant.com/crossword-clue/854194/Frappe
It's not this, you see, that's not so hot	http://www.crosswordgiant.com/crossword-clue/1046411/Its-not-this-you-see-thats-not-so-hot
Hard water	http://www.crosswordgiant.com/crossword-clue/3898/Hard-water
Knock off	http://www.crosswordgiant.com/crossword-clue/39114/Knock-off
Composition of some sheets	http://www.crosswordgiant.com/crossword-clue/47386/Composition-of-some-sheets
Diamonds, to hoods	http://www.crosswordgiant.com/crossword-clue/66290/Diamonds-to-hoods
Make absolutely sure	http://www.crosswordgiant.com/crossword-clue/83387/Make-absolutely-sure
Bar basic	http://www.crosswordgiant.com/crossword-clue/102735/Bar-basic
Cause of a skid	http://www.crosswordgiant.com/crossword-clue/116411/Cause-of-a-skid
Barkeep's supply	http://www.crosswordgiant.com/crossword-clue/125153/Barkeeps-supply
Hockey milieu	http://www.crosswordgiant.com/crossword-clue/148702/Hockey-milieu
Bar stock	http://www.crosswordgiant.com/crossword-clue/159523/Bar-stock
Glacier composition	http://www.crosswordgiant.com/crossword-clue/172300/Glacier-composition
Hotel amenity	http://www.crosswordgiant.com/crossword-clue/211818/Hotel-amenity
Sculptor's medium	http://www.crosswordgiant.com/crossword-clue/216420/Sculptors-medium
What a joke may break	http://www.crosswordgiant.com/crossword-clue/248557/What-a-joke-may-break
Sprain treatment	http://www.crosswordgiant.com/crossword-clue/378519/Sprain-treatment
Black ____	http://www.crosswordgiant.com/crossword-clue/390080/Black-____
Cause of skidding	http://www.crosswordgiant.com/crossword-clue/390276/Cause-of-skidding
Berg composition	http://www.crosswordgiant.com/crossword-clue/400297/Berg-composition
Motel sign	http://www.crosswordgiant.com/crossword-clue/404287/Motel-sign
Swell remedy?	http://www.crosswordgiant.com/crossword-clue/426952/Swell-remedy
Sculpture material, sometimes	http://www.crosswordgiant.com/crossword-clue/456896/Sculpture-material-sometimes
Tend to a sprain	http://www.crosswordgiant.com/crossword-clue/486797/Tend-to-a-sprain
Rocks in a glass	http://www.crosswordgiant.com/crossword-clue/507113/Rocks-in-a-glass
Rock salt may be used on it	http://www.crosswordgiant.com/crossword-clue/570924/Rock-salt-may-be-used-on-it
Frappe need	http://www.crosswordgiant.com/crossword-clue/655261/Frappe-need
Eldridge Cleaver's "Soul on __"	http://www.crosswordgiant.com/crossword-clue/866736/Eldridge-Cleavers-Soul-on-__
Wintry buildup	http://www.crosswordgiant.com/crossword-clue/900476/Wintry-buildup
It's not this, see, that's so cold	http://www.crosswordgiant.com/crossword-clue/1142060/Its-not-this-see-thats-so-cold
Not soft water	http://www.crosswordgiant.com/crossword-clue/1164731/Not-soft-water
Whack	http://www.crosswordgiant.com/crossword-clue/4423/Whack
Chill	http://www.crosswordgiant.com/crossword-clue/8447/Chill
Diamonds, to a gangster	http://www.crosswordgiant.com/crossword-clue/11491/Diamonds-to-a-gangster
Cinch	http://www.crosswordgiant.com/crossword-clue/19658/Cinch
Bump off	http://www.crosswordgiant.com/crossword-clue/33411/Bump-off
Diamonds, to a yegg	http://www.crosswordgiant.com/crossword-clue/38389/Diamonds-to-a-yegg
Rocks, to a bartender	http://www.crosswordgiant.com/crossword-clue/47908/Rocks-to-a-bartender
Clinch, as a deal	http://www.crosswordgiant.com/crossword-clue/56662/Clinch-as-a-deal
Yegg's haul	http://www.crosswordgiant.com/crossword-clue/66741/Yeggs-haul
Screwdriver part	http://www.crosswordgiant.com/crossword-clue/83726/Screwdriver-part
A camel may be executed on it	http://www.crosswordgiant.com/crossword-clue/112317/A-camel-may-be-executed-on-it
Kwan's surface	http://www.crosswordgiant.com/crossword-clue/114616/Kwans-surface
It's cold, regardless of climate	http://www.crosswordgiant.com/crossword-clue/142573/Its-cold-regardless-of-climate
Water one can walk on	http://www.crosswordgiant.com/crossword-clue/147886/Water-one-can-walk-on
Slippery stuff	http://www.crosswordgiant.com/crossword-clue/151006/Slippery-stuff
Sprain application	http://www.crosswordgiant.com/crossword-clue/160912/Sprain-application
Skater's surface	http://www.crosswordgiant.com/crossword-clue/164181/Skaters-surface
Sculpture medium	http://www.crosswordgiant.com/crossword-clue/198625/Sculpture-medium
Winter Olympics need	http://www.crosswordgiant.com/crossword-clue/200476/Winter-Olympics-need
Zamboni's surface	http://www.crosswordgiant.com/crossword-clue/209082/Zambonis-surface
Party purchase	http://www.crosswordgiant.com/crossword-clue/210636/Party-purchase
What chit-chat may break	http://www.crosswordgiant.com/crossword-clue/217594/What-chit-chat-may-break
Finish the cake	http://www.crosswordgiant.com/crossword-clue/219040/Finish-the-cake
It may be crushed	http://www.crosswordgiant.com/crossword-clue/219577/It-may-be-crushed
Cubes in a glass	http://www.crosswordgiant.com/crossword-clue/222523/Cubes-in-a-glass
Driving danger	http://www.crosswordgiant.com/crossword-clue/239114/Driving-danger
Top the cake	http://www.crosswordgiant.com/crossword-clue/245816/Top-the-cake
Water you can walk on	http://www.crosswordgiant.com/crossword-clue/248390/Water-you-can-walk-on
Rink makeup	http://www.crosswordgiant.com/crossword-clue/250730/Rink-makeup
Bar rocks	http://www.crosswordgiant.com/crossword-clue/256036/Bar-rocks
Chest contents, often	http://www.crosswordgiant.com/crossword-clue/258569/Chest-contents-often
It's sometimes sold in bags	http://www.crosswordgiant.com/crossword-clue/259414/Its-sometimes-sold-in-bags
Rocks, at the bar	http://www.crosswordgiant.com/crossword-clue/266434/Rocks-at-the-bar
Medium for some sculptures	http://www.crosswordgiant.com/crossword-clue/269434/Medium-for-some-sculptures
Capades venue	http://www.crosswordgiant.com/crossword-clue/272839/Capades-venue
Bering Strait sight	http://www.crosswordgiant.com/crossword-clue/286884/Bering-Strait-sight
Restaurant block	http://www.crosswordgiant.com/crossword-clue/311572/Restaurant-block
Daiquiri need	http://www.crosswordgiant.com/crossword-clue/315458/Daiquiri-need
Word with box or cream	http://www.crosswordgiant.com/crossword-clue/317624/Word-with-box-or-cream
Bling-bling component, often	http://www.crosswordgiant.com/crossword-clue/325583/Bling-bling-component-often
Pack or pick preceder	http://www.crosswordgiant.com/crossword-clue/368075/Pack-or-pick-preceder
Chilling pieces?	http://www.crosswordgiant.com/crossword-clue/399967/Chilling-pieces
Medium for playing the Blues?	http://www.crosswordgiant.com/crossword-clue/418353/Medium-for-playing-the-Blues
Treat, as a sprain	http://www.crosswordgiant.com/crossword-clue/423657/Treat-as-a-sprain
It may be in blocks	http://www.crosswordgiant.com/crossword-clue/432631/It-may-be-in-blocks
Diamonds, to yeggs	http://www.crosswordgiant.com/crossword-clue/437286/Diamonds-to-yeggs
Rink stuff	http://www.crosswordgiant.com/crossword-clue/440798/Rink-stuff
Make sure of	http://www.crosswordgiant.com/crossword-clue/446986/Make-sure-of
Cubes in a bucket	http://www.crosswordgiant.com/crossword-clue/554116/Cubes-in-a-bucket
Home ___ (hockey advantage)	http://www.crosswordgiant.com/crossword-clue/575964/Home-___-hockey-advantage
Sno-cone filler	http://www.crosswordgiant.com/crossword-clue/579625/Sno-cone-filler
-- -cold	http://www.crosswordgiant.com/crossword-clue/583400/-cold
Bartender's supply	http://www.crosswordgiant.com/crossword-clue/689178/Bartenders-supply
Chiller of a sort	http://www.crosswordgiant.com/crossword-clue/726344/Chiller-of-a-sort
Misplay a puck	http://www.crosswordgiant.com/crossword-clue/734559/Misplay-a-puck
Lock up	http://www.crosswordgiant.com/crossword-clue/762638/Lock-up
Winter sidewalk hazard	http://www.crosswordgiant.com/crossword-clue/766615/Winter-sidewalk-hazard
Temporary sculpture medium	http://www.crosswordgiant.com/crossword-clue/776036/Temporary-sculpture-medium
Arctic surface	http://www.crosswordgiant.com/crossword-clue/825916/Arctic-surface
Type of cube or chest	http://www.crosswordgiant.com/crossword-clue/864556/Type-of-cube-or-chest
Rocks in a tumbler	http://www.crosswordgiant.com/crossword-clue/934291/Rocks-in-a-tumbler
It's hard not to see this	http://www.crosswordgiant.com/crossword-clue/1055238/Its-hard-not-to-see-this
It's not this, you see, that's so hard	http://www.crosswordgiant.com/crossword-clue/1080912/Its-not-this-you-see-thats-so-hard
Hard to reach a cold conclusion to 1 across	http://www.crosswordgiant.com/crossword-clue/1175010/Hard-to-reach-a-cold-conclusion-to-1-across
After Nov. there's nothing wrong being so cold anew	http://www.crosswordgiant.com/crossword-clue/1179203/After-Nov.-theres-nothing-wrong-being-so-cold-anew
Would not this make one feel the cold?	http://www.crosswordgiant.com/crossword-clue/1181099/Would-not-this-make-one-feel-the-cold
'Not this, see, it's cold (3)'	http://www.crosswordgiant.com/crossword-clue/1182262/Not-this-see-its-cold-3
It's not this that's so hard to get cold	http://www.crosswordgiant.com/crossword-clue/1185290/Its-not-this-thats-so-hard-to-get-cold
How sweet such cream is, but not so hot	http://www.crosswordgiant.com/crossword-clue/1186060/How-sweet-such-cream-is-but-not-so-hot
Perhaps it's not so frozen, see?	http://www.crosswordgiant.com/crossword-clue/1187561/Perhaps-its-not-so-frozen-see
See, it's not this that makes the water hard	http://www.crosswordgiant.com/crossword-clue/1188658/See-its-not-this-that-makes-the-water-hard
Word in many beer names	http://www.crosswordgiant.com/crossword-clue/1202218/Word-in-many-beer-names
"Cool" target for a yegg?	http://www.crosswordgiant.com/crossword-clue/1249474/Cool-target-for-a-yegg
Rocks, in a bar	http://www.crosswordgiant.com/crossword-clue/1452803/Rocks-in-a-bar
Rocks for a White Russian	http://www.crosswordgiant.com/crossword-clue/1487068/Rocks-for-a-White-Russian
Motel machine sign	http://www.crosswordgiant.com/crossword-clue/1491381/Motel-machine-sign
Pitcher's after-game need	http://www.crosswordgiant.com/crossword-clue/1492434/Pitchers-after-game-need
Freeze	http://www.crosswordgiant.com/crossword-clue/4254/Freeze
Kind of beer	http://www.crosswordgiant.com/crossword-clue/4885/Kind-of-beer
'Rhyme Pays' rapper	http://www.crosswordgiant.com/crossword-clue/5969/Rhyme-Pays-rapper
Word with bag or cap	http://www.crosswordgiant.com/crossword-clue/12356/Word-with-bag-or-cap
Secure	http://www.crosswordgiant.com/crossword-clue/13946/Secure
Off	http://www.crosswordgiant.com/crossword-clue/15496/Off
Coolness	http://www.crosswordgiant.com/crossword-clue/24626/Coolness
Contents of some buckets	http://www.crosswordgiant.com/crossword-clue/28764/Contents-of-some-buckets
Diamonds, in criminal slang	http://www.crosswordgiant.com/crossword-clue/31961/Diamonds-in-criminal-slang
Cooler	http://www.crosswordgiant.com/crossword-clue/32249/Cooler
Secure, as a victory	http://www.crosswordgiant.com/crossword-clue/32578/Secure-as-a-victory
Make final	http://www.crosswordgiant.com/crossword-clue/40229/Make-final
Broomball surface	http://www.crosswordgiant.com/crossword-clue/45506/Broomball-surface
Kind of bag or chest	http://www.crosswordgiant.com/crossword-clue/46922/Kind-of-bag-or-chest
Bar staple	http://www.crosswordgiant.com/crossword-clue/47396/Bar-staple
Vanilla ___	http://www.crosswordgiant.com/crossword-clue/57902/Vanilla-___
Polar formation	http://www.crosswordgiant.com/crossword-clue/68387/Polar-formation
Break the ___	http://www.crosswordgiant.com/crossword-clue/68771/Break-the-___
Crystal	http://www.crosswordgiant.com/crossword-clue/69458/Crystal
With 10-Across, treatment for a swelling	http://www.crosswordgiant.com/crossword-clue/71536/With-10-Across-treatment-for-a-swelling
Christmas traveler's worry	http://www.crosswordgiant.com/crossword-clue/73672/Christmas-travelers-worry
Pilot's worry	http://www.crosswordgiant.com/crossword-clue/75997/Pilots-worry
Chiller	http://www.crosswordgiant.com/crossword-clue/77158/Chiller
Bartender's 'rocks'	http://www.crosswordgiant.com/crossword-clue/80771/Bartenders-rocks
Rocks, to Isaac on ''The Love Boat''	http://www.crosswordgiant.com/crossword-clue/104226/Rocks-to-Isaac-on-The-Love-Boat
Tavern supply	http://www.crosswordgiant.com/crossword-clue/111793/Tavern-supply
Kind of fishing	http://www.crosswordgiant.com/crossword-clue/116001/Kind-of-fishing
Word with cap or pack	http://www.crosswordgiant.com/crossword-clue/124846/Word-with-cap-or-pack
Word with hockey or bucket	http://www.crosswordgiant.com/crossword-clue/127637/Word-with-hockey-or-bucket
Kind of jam	http://www.crosswordgiant.com/crossword-clue/130690/Kind-of-jam
Jewelry, to a yegg	http://www.crosswordgiant.com/crossword-clue/140243/Jewelry-to-a-yegg
Word with cap or cube	http://www.crosswordgiant.com/crossword-clue/144124/Word-with-cap-or-cube
Rink medium	http://www.crosswordgiant.com/crossword-clue/144302/Rink-medium
Rocks in bars	http://www.crosswordgiant.com/crossword-clue/149992/Rocks-in-bars
Cap material	http://www.crosswordgiant.com/crossword-clue/158551/Cap-material
Kind of bag or axe	http://www.crosswordgiant.com/crossword-clue/161137/Kind-of-bag-or-axe
___ cream	http://www.crosswordgiant.com/crossword-clue/184589/___-cream
Off, in a way	http://www.crosswordgiant.com/crossword-clue/189018/Off-in-a-way
Yamaguchi's milieu	http://www.crosswordgiant.com/crossword-clue/196933/Yamaguchis-milieu
H2O below 32 degrees	http://www.crosswordgiant.com/crossword-clue/208100/H2O-below-32-degrees
Jet hazard	http://www.crosswordgiant.com/crossword-clue/208231/Jet-hazard
Shelf material	http://www.crosswordgiant.com/crossword-clue/211217/Shelf-material
Creator of a slippery slope	http://www.crosswordgiant.com/crossword-clue/212704/Creator-of-a-slippery-slope
Tea additive	http://www.crosswordgiant.com/crossword-clue/219991/Tea-additive
Undesirable wing coating	http://www.crosswordgiant.com/crossword-clue/224763/Undesirable-wing-coating
Witt's milieu	http://www.crosswordgiant.com/crossword-clue/225827/Witts-milieu
Sparklers	http://www.crosswordgiant.com/crossword-clue/229257/Sparklers
Locale for 'Capades'	http://www.crosswordgiant.com/crossword-clue/233718/Locale-for-Capades
Rocks at the bar ,	http://www.crosswordgiant.com/crossword-clue/234763/Rocks-at-the-bar-
Harbor problem	http://www.crosswordgiant.com/crossword-clue/238584/Harbor-problem
Venue for 'capades'	http://www.crosswordgiant.com/crossword-clue/242859/Venue-for-capades
Bartending need	http://www.crosswordgiant.com/crossword-clue/244475/Bartending-need
Some cubes	http://www.crosswordgiant.com/crossword-clue/246694/Some-cubes
Hockey need	http://www.crosswordgiant.com/crossword-clue/246930/Hockey-need
-- water	http://www.crosswordgiant.com/crossword-clue/247061/-water
Witt's surface	http://www.crosswordgiant.com/crossword-clue/257559/Witts-surface
Diamonds, in mob lingo	http://www.crosswordgiant.com/crossword-clue/257752/Diamonds-in-mob-lingo
Venue for 6-Down	http://www.crosswordgiant.com/crossword-clue/261908/Venue-for-6-Down
Convenience store bagful	http://www.crosswordgiant.com/crossword-clue/262943/Convenience-store-bagful
It's hard to get a grip on	http://www.crosswordgiant.com/crossword-clue/264943/Its-hard-to-get-a-grip-on
Cooler contents	http://www.crosswordgiant.com/crossword-clue/265443/Cooler-contents
Gretzky's milieu	http://www.crosswordgiant.com/crossword-clue/267804/Gretzkys-milieu
Cooler for coolers	http://www.crosswordgiant.com/crossword-clue/268788/Cooler-for-coolers
Word with cream or box	http://www.crosswordgiant.com/crossword-clue/269533/Word-with-cream-or-box
Kind of beer or bag	http://www.crosswordgiant.com/crossword-clue/273345/Kind-of-beer-or-bag
Bucket type	http://www.crosswordgiant.com/crossword-clue/273955/Bucket-type
Eskimo building material	http://www.crosswordgiant.com/crossword-clue/275940/Eskimo-building-material
Road  hazard	http://www.crosswordgiant.com/crossword-clue/276846/Road-hazard
Mixer's frozen asset	http://www.crosswordgiant.com/crossword-clue/280184/Mixers-frozen-asset
Freezer item	http://www.crosswordgiant.com/crossword-clue/282050/Freezer-item
Rangers' place	http://www.crosswordgiant.com/crossword-clue/286374/Rangers-place
Gems, slangily	http://www.crosswordgiant.com/crossword-clue/286384/Gems-slangily
Skating need	http://www.crosswordgiant.com/crossword-clue/287709/Skating-need
Baiul's milieu	http://www.crosswordgiant.com/crossword-clue/291648/Baiuls-milieu
Milieu for 27-Down	http://www.crosswordgiant.com/crossword-clue/295534/Milieu-for-27-Down
Apply frosting	http://www.crosswordgiant.com/crossword-clue/297534/Apply-frosting
Crunchable cubes	http://www.crosswordgiant.com/crossword-clue/299037/Crunchable-cubes
Vanilla of rap	http://www.crosswordgiant.com/crossword-clue/307259/Vanilla-of-rap
Popsicle, essentially	http://www.crosswordgiant.com/crossword-clue/308238/Popsicle-essentially
Something found in a sheet	http://www.crosswordgiant.com/crossword-clue/308278/Something-found-in-a-sheet
NHL venue	http://www.crosswordgiant.com/crossword-clue/312175/NHL-venue
Tray filler	http://www.crosswordgiant.com/crossword-clue/316415/Tray-filler
Bar necessity	http://www.crosswordgiant.com/crossword-clue/325136/Bar-necessity
Glacier feature	http://www.crosswordgiant.com/crossword-clue/327805/Glacier-feature
Mixer's asset	http://www.crosswordgiant.com/crossword-clue/329926/Mixers-asset
Cool stuff hidden in eight puzzle answers	http://www.crosswordgiant.com/crossword-clue/338013/Cool-stuff-hidden-in-eight-puzzle-answers
Word with show or box	http://www.crosswordgiant.com/crossword-clue/338243/Word-with-show-or-box
Drink's need	http://www.crosswordgiant.com/crossword-clue/350644/Drinks-need
Cooler filler	http://www.crosswordgiant.com/crossword-clue/351199/Cooler-filler
Milieu for 1-Across	http://www.crosswordgiant.com/crossword-clue/356837/Milieu-for-1-Across
Rink floor	http://www.crosswordgiant.com/crossword-clue/357944/Rink-floor
Word with tray or cube	http://www.crosswordgiant.com/crossword-clue/360517/Word-with-tray-or-cube
It may be found in a sheet	http://www.crosswordgiant.com/crossword-clue/363569/It-may-be-found-in-a-sheet
Diamonds, in slang	http://www.crosswordgiant.com/crossword-clue/366752/Diamonds-in-slang
Block in a restaurant?	http://www.crosswordgiant.com/crossword-clue/374843/Block-in-a-restaurant
Winter peril	http://www.crosswordgiant.com/crossword-clue/377785/Winter-peril
Water you may walk on	http://www.crosswordgiant.com/crossword-clue/378036/Water-you-may-walk-on
It can be shaved or cracked	http://www.crosswordgiant.com/crossword-clue/379566/It-can-be-shaved-or-cracked
Something to slip on	http://www.crosswordgiant.com/crossword-clue/380513/Something-to-slip-on
Boardwalk treat	http://www.crosswordgiant.com/crossword-clue/382277/Boardwalk-treat
Much of Greenland	http://www.crosswordgiant.com/crossword-clue/394085/Much-of-Greenland
Hail, e.g.	http://www.crosswordgiant.com/crossword-clue/401038/Hail-e.g
Stanley Cup venue	http://www.crosswordgiant.com/crossword-clue/402309/Stanley-Cup-venue
Rocks in a bar?	http://www.crosswordgiant.com/crossword-clue/407120/Rocks-in-a-bar
Diamonds (Sl.)	http://www.crosswordgiant.com/crossword-clue/410557/Diamonds-Sl
With 5-Across, axel performer	http://www.crosswordgiant.com/crossword-clue/411605/With-5-Across-axel-performer
Smoothie ingredient	http://www.crosswordgiant.com/crossword-clue/411632/Smoothie-ingredient
Katarina Witt's arena	http://www.crosswordgiant.com/crossword-clue/412374/Katarina-Witts-arena
Hockey  surface	http://www.crosswordgiant.com/crossword-clue/415768/Hockey-surface
Cube-shaped rocks?	http://www.crosswordgiant.com/crossword-clue/416260/Cube-shaped-rocks
Medium for temporary statues	http://www.crosswordgiant.com/crossword-clue/416705/Medium-for-temporary-statues
Cap material?	http://www.crosswordgiant.com/crossword-clue/416962/Cap-material
Word with cap or cream	http://www.crosswordgiant.com/crossword-clue/419577/Word-with-cap-or-cream
Hazard to navigation	http://www.crosswordgiant.com/crossword-clue/420649/Hazard-to-navigation
Winter coat?	http://www.crosswordgiant.com/crossword-clue/426959/Winter-coat
Wintry coating	http://www.crosswordgiant.com/crossword-clue/427308/Wintry-coating
Luge surface	http://www.crosswordgiant.com/crossword-clue/434456/Luge-surface
Stuff in trays	http://www.crosswordgiant.com/crossword-clue/440878/Stuff-in-trays
Shelf component, perhaps	http://www.crosswordgiant.com/crossword-clue/442296/Shelf-component-perhaps
Decorate, as a 54-Down	http://www.crosswordgiant.com/crossword-clue/442436/Decorate-as-a-54-Down
Substance for sculptures	http://www.crosswordgiant.com/crossword-clue/442864/Substance-for-sculptures
Wintry covering	http://www.crosswordgiant.com/crossword-clue/449042/Wintry-covering
Rocks from a bucket	http://www.crosswordgiant.com/crossword-clue/451015/Rocks-from-a-bucket
It'll melt in your mouth	http://www.crosswordgiant.com/crossword-clue/457226/Itll-melt-in-your-mouth
Freezer trayful	http://www.crosswordgiant.com/crossword-clue/458117/Freezer-trayful
Cube or cream preceder	http://www.crosswordgiant.com/crossword-clue/467092/Cube-or-cream-preceder
Preserve, perhaps	http://www.crosswordgiant.com/crossword-clue/467093/Preserve-perhaps
Glacier make-up	http://www.crosswordgiant.com/crossword-clue/476615/Glacier-make-up
Cooling cubes	http://www.crosswordgiant.com/crossword-clue/482148/Cooling-cubes
Old pushcart cry	http://www.crosswordgiant.com/crossword-clue/483695/Old-pushcart-cry
Cold blocks	http://www.crosswordgiant.com/crossword-clue/490293/Cold-blocks
Gretzky's stage	http://www.crosswordgiant.com/crossword-clue/495125/Gretzkys-stage
Top tortes	http://www.crosswordgiant.com/crossword-clue/499939/Top-tortes
Floor for Orr	http://www.crosswordgiant.com/crossword-clue/508572/Floor-for-Orr
Rangers' play area	http://www.crosswordgiant.com/crossword-clue/513851/Rangers-play-area
Word with pack or pick	http://www.crosswordgiant.com/crossword-clue/514667/Word-with-pack-or-pick
Tea addition	http://www.crosswordgiant.com/crossword-clue/521866/Tea-addition
Finish a cake	http://www.crosswordgiant.com/crossword-clue/523170/Finish-a-cake
Cubes in a bar	http://www.crosswordgiant.com/crossword-clue/524136/Cubes-in-a-bar
Word before maker or breaker	http://www.crosswordgiant.com/crossword-clue/526794/Word-before-maker-or-breaker
Cola cubes	http://www.crosswordgiant.com/crossword-clue/530786/Cola-cubes
Crook's diamonds	http://www.crosswordgiant.com/crossword-clue/534611/Crooks-diamonds
Put away for good	http://www.crosswordgiant.com/crossword-clue/542448/Put-away-for-good
Chilly cubes	http://www.crosswordgiant.com/crossword-clue/545626/Chilly-cubes
Olympic dancing venue	http://www.crosswordgiant.com/crossword-clue/547202/Olympic-dancing-venue
Windshield annoyance	http://www.crosswordgiant.com/crossword-clue/549577/Windshield-annoyance
Windshield inconvenience	http://www.crosswordgiant.com/crossword-clue/550160/Windshield-inconvenience
Rocks in a cocktail	http://www.crosswordgiant.com/crossword-clue/550395/Rocks-in-a-cocktail
''Fire and ___'' by Robert Frost	http://www.crosswordgiant.com/crossword-clue/554080/Fire-and-___-by-Robert-Frost
Drink coolant	http://www.crosswordgiant.com/crossword-clue/556155/Drink-coolant
Boitano's surface	http://www.crosswordgiant.com/crossword-clue/556197/Boitanos-surface
Rocks, maybe	http://www.crosswordgiant.com/crossword-clue/560701/Rocks-maybe
Hockey or curling surface	http://www.crosswordgiant.com/crossword-clue/563654/Hockey-or-curling-surface
Assure, as a victory	http://www.crosswordgiant.com/crossword-clue/567576/Assure-as-a-victory
Curling setting	http://www.crosswordgiant.com/crossword-clue/570930/Curling-setting
Dentyne brand	http://www.crosswordgiant.com/crossword-clue/574876/Dentyne-brand
Jewelry, to R. Kelly	http://www.crosswordgiant.com/crossword-clue/578625/Jewelry-to-R.-Kelly
Surface for Sharks	http://www.crosswordgiant.com/crossword-clue/582146/Surface-for-Sharks
Type of chest	http://www.crosswordgiant.com/crossword-clue/594886/Type-of-chest
Ephemeral sculpting medium	http://www.crosswordgiant.com/crossword-clue/599077/Ephemeral-sculpting-medium
Nail down	http://www.crosswordgiant.com/crossword-clue/605095/Nail-down
Wine cooler	http://www.crosswordgiant.com/crossword-clue/605462/Wine-cooler
Bucket filler	http://www.crosswordgiant.com/crossword-clue/605838/Bucket-filler
Rocks in the freezer	http://www.crosswordgiant.com/crossword-clue/606396/Rocks-in-the-freezer
It's never in a neat order	http://www.crosswordgiant.com/crossword-clue/608677/Its-never-in-a-neat-order
Bump off (Sl.)	http://www.crosswordgiant.com/crossword-clue/611250/Bump-off-Sl
Top a torte	http://www.crosswordgiant.com/crossword-clue/614670/Top-a-torte
Skid cause	http://www.crosswordgiant.com/crossword-clue/619159/Skid-cause
Relieve the pressure, in a way	http://www.crosswordgiant.com/crossword-clue/619987/Relieve-the-pressure-in-a-way
Certain sculpting medium	http://www.crosswordgiant.com/crossword-clue/620724/Certain-sculpting-medium
Type of cube	http://www.crosswordgiant.com/crossword-clue/622877/Type-of-cube
Glacial material	http://www.crosswordgiant.com/crossword-clue/623594/Glacial-material
Arctic landscape	http://www.crosswordgiant.com/crossword-clue/625711/Arctic-landscape
''___ Station Zebra''	http://www.crosswordgiant.com/crossword-clue/626762/___-Station-Zebra
Word in several 4D monikers	http://www.crosswordgiant.com/crossword-clue/629485/Word-in-several-4D-monikers
Cool stuff	http://www.crosswordgiant.com/crossword-clue/636383/Cool-stuff
Sno-cone base	http://www.crosswordgiant.com/crossword-clue/639540/Sno-cone-base
Hot stones	http://www.crosswordgiant.com/crossword-clue/641841/Hot-stones
Age that came with a chill	http://www.crosswordgiant.com/crossword-clue/644351/Age-that-came-with-a-chill
Supermarket bagful	http://www.crosswordgiant.com/crossword-clue/646055/Supermarket-bagful
Zamboni's place	http://www.crosswordgiant.com/crossword-clue/652849/Zambonis-place
It may be shaved	http://www.crosswordgiant.com/crossword-clue/657312/It-may-be-shaved
Machine in a motel	http://www.crosswordgiant.com/crossword-clue/660895/Machine-in-a-motel
Some crystals	http://www.crosswordgiant.com/crossword-clue/666029/Some-crystals
Main component of Saturn's rings	http://www.crosswordgiant.com/crossword-clue/667659/Main-component-of-Saturns-rings
Word with ''maker'' or ''breaker''	http://www.crosswordgiant.com/crossword-clue/672044/Word-with-maker-or-breaker
____cap	http://www.crosswordgiant.com/crossword-clue/681852/____cap
Chains et al.	http://www.crosswordgiant.com/crossword-clue/682351/Chains-et-al
Word with ''skate'' or ''water''	http://www.crosswordgiant.com/crossword-clue/683116/Word-with-skate-or-water
Skier's bane	http://www.crosswordgiant.com/crossword-clue/683540/Skiers-bane
Zamboni's surface	http://www.crosswordgiant.com/crossword-clue/686082/Zambonis-surface
Capades locale	http://www.crosswordgiant.com/crossword-clue/691287/Capades-locale
Dispose of, in a way	http://www.crosswordgiant.com/crossword-clue/693231/Dispose-of-in-a-way
Capades site	http://www.crosswordgiant.com/crossword-clue/701948/Capades-site
Zamboni's milieu	http://www.crosswordgiant.com/crossword-clue/704116/Zambonis-milieu
NHL surface	http://www.crosswordgiant.com/crossword-clue/705412/NHL-surface
Freezer cubes	http://www.crosswordgiant.com/crossword-clue/706917/Freezer-cubes
Winter formation	http://www.crosswordgiant.com/crossword-clue/708887/Winter-formation
Meth, slangily	http://www.crosswordgiant.com/crossword-clue/711407/Meth-slangily
With 46-Across, emulate Peggy Fleming	http://www.crosswordgiant.com/crossword-clue/714587/With-46-Across-emulate-Peggy-Fleming
Diamonds, to a fence	http://www.crosswordgiant.com/crossword-clue/715314/Diamonds-to-a-fence
Swelling aid	http://www.crosswordgiant.com/crossword-clue/717538/Swelling-aid
Alternative in a Frost poem	http://www.crosswordgiant.com/crossword-clue/721662/Alternative-in-a-Frost-poem
Jewelry or meth, in slang	http://www.crosswordgiant.com/crossword-clue/721767/Jewelry-or-meth-in-slang
It keeps things from being neat	http://www.crosswordgiant.com/crossword-clue/723016/It-keeps-things-from-being-neat
Setting for Capades	http://www.crosswordgiant.com/crossword-clue/725571/Setting-for-Capades
Seal, as a victory	http://www.crosswordgiant.com/crossword-clue/727560/Seal-as-a-victory
Pepsi cooler	http://www.crosswordgiant.com/crossword-clue/729137/Pepsi-cooler
"___ Station Zebra"	http://www.crosswordgiant.com/crossword-clue/731978/___-Station-Zebra
Curling sheet	http://www.crosswordgiant.com/crossword-clue/736499/Curling-sheet
Cubes in a freezer	http://www.crosswordgiant.com/crossword-clue/736535/Cubes-in-a-freezer
Bartender's rocks	http://www.crosswordgiant.com/crossword-clue/738820/Bartenders-rocks
Misplay the puck	http://www.crosswordgiant.com/crossword-clue/742302/Misplay-the-puck
Sheet on the road, perhaps	http://www.crosswordgiant.com/crossword-clue/744828/Sheet-on-the-road-perhaps
Zamboni milieu	http://www.crosswordgiant.com/crossword-clue/748402/Zamboni-milieu
Word with "water" or "maker"	http://www.crosswordgiant.com/crossword-clue/748511/Word-with-water-or-maker
Requirement for curlers	http://www.crosswordgiant.com/crossword-clue/758240/Requirement-for-curlers
Dry __	http://www.crosswordgiant.com/crossword-clue/759098/Dry-__
Rink base	http://www.crosswordgiant.com/crossword-clue/763731/Rink-base
Diamonds, to a thief	http://www.crosswordgiant.com/crossword-clue/769026/Diamonds-to-a-thief
Kill, in mob slang	http://www.crosswordgiant.com/crossword-clue/770655/Kill-in-mob-slang
___ Capades (skating show)	http://www.crosswordgiant.com/crossword-clue/775820/___-Capades-skating-show
Hot diamonds	http://www.crosswordgiant.com/crossword-clue/777707/Hot-diamonds
Bartender's rocks	http://www.crosswordgiant.com/crossword-clue/780148/Bartenders-rocks
Bruise treatment	http://www.crosswordgiant.com/crossword-clue/782303/Bruise-treatment
Sprain remedy	http://www.crosswordgiant.com/crossword-clue/786270/Sprain-remedy
Bucket or pack filler	http://www.crosswordgiant.com/crossword-clue/789242/Bucket-or-pack-filler
Cooler drink	http://www.crosswordgiant.com/crossword-clue/795350/Cooler-drink
Some bling	http://www.crosswordgiant.com/crossword-clue/797449/Some-bling
Cold cube	http://www.crosswordgiant.com/crossword-clue/797824/Cold-cube
26-Across supply	http://www.crosswordgiant.com/crossword-clue/799235/26-Across-supply
Jewelry	http://www.crosswordgiant.com/crossword-clue/799550/Jewelry
Cubes from the freezer	http://www.crosswordgiant.com/crossword-clue/802444/Cubes-from-the-freezer
Rocks for a Black Russian	http://www.crosswordgiant.com/crossword-clue/804592/Rocks-for-a-Black-Russian
Cool cubes	http://www.crosswordgiant.com/crossword-clue/806993/Cool-cubes
It's sold in bags or blocks	http://www.crosswordgiant.com/crossword-clue/807306/Its-sold-in-bags-or-blocks
Black ___ (winter highway hazard)	http://www.crosswordgiant.com/crossword-clue/810120/Black-___-winter-highway-hazard
Beverage store buy	http://www.crosswordgiant.com/crossword-clue/812313/Beverage-store-buy
Venue for Capades	http://www.crosswordgiant.com/crossword-clue/813072/Venue-for-Capades
Cube makeup	http://www.crosswordgiant.com/crossword-clue/814468/Cube-makeup
It keeps drinks from being neat	http://www.crosswordgiant.com/crossword-clue/816866/It-keeps-drinks-from-being-neat
Cruise sculptor's medium	http://www.crosswordgiant.com/crossword-clue/818834/Cruise-sculptors-medium
Rocks, at a bar	http://www.crosswordgiant.com/crossword-clue/821496/Rocks-at-a-bar
Cooler in the cooler	http://www.crosswordgiant.com/crossword-clue/822561/Cooler-in-the-cooler
Hockey arena	http://www.crosswordgiant.com/crossword-clue/823843/Hockey-arena
Treatment for swelling	http://www.crosswordgiant.com/crossword-clue/830358/Treatment-for-swelling
Rocks, to a barkeep	http://www.crosswordgiant.com/crossword-clue/830612/Rocks-to-a-barkeep
Most of Antarctica	http://www.crosswordgiant.com/crossword-clue/832553/Most-of-Antarctica
Force to drink a disgusting Smirnoff beverage, in bro-speak	http://www.crosswordgiant.com/crossword-clue/835782/Force-to-drink-a-disgusting-Smirnoff-beverage-in-bro-speak
Beverage-store bagful	http://www.crosswordgiant.com/crossword-clue/840913/Beverage-store-bagful
Assure victory in, slangily	http://www.crosswordgiant.com/crossword-clue/843252/Assure-victory-in-slangily
Manhattan cooler?	http://www.crosswordgiant.com/crossword-clue/844444/Manhattan-cooler
Snow cone base	http://www.crosswordgiant.com/crossword-clue/848921/Snow-cone-base
Some people like their espresso poured over it	http://www.crosswordgiant.com/crossword-clue/851389/Some-people-like-their-espresso-poured-over-it
37-Across material	http://www.crosswordgiant.com/crossword-clue/856136/37-Across-material
What most of hail is	http://www.crosswordgiant.com/crossword-clue/856186/What-most-of-hail-is
Epitome of coldness	http://www.crosswordgiant.com/crossword-clue/859034/Epitome-of-coldness
Number in a pack?	http://www.crosswordgiant.com/crossword-clue/859315/Number-in-a-pack
Winter walking peril	http://www.crosswordgiant.com/crossword-clue/861034/Winter-walking-peril
Berg material	http://www.crosswordgiant.com/crossword-clue/867543/Berg-material
Sculpting material, sometimes	http://www.crosswordgiant.com/crossword-clue/867999/Sculpting-material-sometimes
Cooler cubes	http://www.crosswordgiant.com/crossword-clue/869577/Cooler-cubes
Zamboni surface	http://www.crosswordgiant.com/crossword-clue/886799/Zamboni-surface
Frost a cake	http://www.crosswordgiant.com/crossword-clue/886863/Frost-a-cake
Freezer buildup	http://www.crosswordgiant.com/crossword-clue/887225/Freezer-buildup
Apply frosting to	http://www.crosswordgiant.com/crossword-clue/901818/Apply-frosting-to
Hotel bucketful	http://www.crosswordgiant.com/crossword-clue/905586/Hotel-bucketful
Floe material	http://www.crosswordgiant.com/crossword-clue/908204/Floe-material
Jewels, slangily	http://www.crosswordgiant.com/crossword-clue/915803/Jewels-slangily
Plans may be put on it	http://www.crosswordgiant.com/crossword-clue/922056/Plans-may-be-put-on-it
6-Down's surface	http://www.crosswordgiant.com/crossword-clue/928264/6-Downs-surface
The ends of 20-, 39- and 56-Across are forms of it	http://www.crosswordgiant.com/crossword-clue/931967/The-ends-of-20-39-and-56-Across-are-forms-of-it
Party host's bagful	http://www.crosswordgiant.com/crossword-clue/932826/Party-hosts-bagful
To put in a drink or slide on	http://www.crosswordgiant.com/crossword-clue/949990/To-put-in-a-drink-or-slide-on
Cold stuff used in enticement	http://www.crosswordgiant.com/crossword-clue/960038/Cold-stuff-used-in-enticement
Constituent of 2dn	http://www.crosswordgiant.com/crossword-clue/1022329/Constituent-of-2dn
Solid H2O	http://www.crosswordgiant.com/crossword-clue/1036060/Solid-H2O
If it's thin, skating on it can be dangerous	http://www.crosswordgiant.com/crossword-clue/1042279/If-its-thin-skating-on-it-can-be-dangerous
It's hard to see it's not so cold	http://www.crosswordgiant.com/crossword-clue/1043625/Its-hard-to-see-its-not-so-cold
It's not that that's not so hot, you see	http://www.crosswordgiant.com/crossword-clue/1047914/Its-not-that-thats-not-so-hot-you-see
It's hard to put it in the hard stuff	http://www.crosswordgiant.com/crossword-clue/1048188/Its-hard-to-put-it-in-the-hard-stuff
See, it's not this for 25 down - or is it?	http://www.crosswordgiant.com/crossword-clue/1050396/See-its-not-this-for-25-down-or-is-it
It's not there, you see!	http://www.crosswordgiant.com/crossword-clue/1053506/Its-not-there-you-see
It may not be so hard, you see	http://www.crosswordgiant.com/crossword-clue/1053846/It-may-not-be-so-hard-you-see
Is it not this that you give when you're going?	http://www.crosswordgiant.com/crossword-clue/1054313/Is-it-not-this-that-you-give-when-youre-going
One goes off to this for work when it's cold	http://www.crosswordgiant.com/crossword-clue/1057338/One-goes-off-to-this-for-work-when-its-cold
It's hard to get off this for work	http://www.crosswordgiant.com/crossword-clue/1058637/Its-hard-to-get-off-this-for-work
Can you see that it's not this that's cold?	http://www.crosswordgiant.com/crossword-clue/1059551/Can-you-see-that-its-not-this-thats-cold
It's hard to get to the bottom of 18 down	http://www.crosswordgiant.com/crossword-clue/1060165/Its-hard-to-get-to-the-bottom-of-18-down
You'll see it's not for the thaw	http://www.crosswordgiant.com/crossword-clue/1061380/Youll-see-its-not-for-the-thaw
It's hard to have got off with doing some work there	http://www.crosswordgiant.com/crossword-clue/1063007/Its-hard-to-have-got-off-with-doing-some-work-there
Hard to see how this could follow 14 down	http://www.crosswordgiant.com/crossword-clue/1063715/Hard-to-see-how-this-could-follow-14-down
It's not so hot to be so hard and get so bad after five	http://www.crosswordgiant.com/crossword-clue/1064950/Its-not-so-hot-to-be-so-hard-and-get-so-bad-after-five
It's hard to find such land in the Atlantic	http://www.crosswordgiant.com/crossword-clue/1065359/Its-hard-to-find-such-land-in-the-Atlantic
It's not this to 17 down	http://www.crosswordgiant.com/crossword-clue/1066732/Its-not-this-to-17-down
The north makes it so welcome to be so cold	http://www.crosswordgiant.com/crossword-clue/1067706/The-north-makes-it-so-welcome-to-be-so-cold
You'll see that it's not this that's not hot	http://www.crosswordgiant.com/crossword-clue/1068511/Youll-see-that-its-not-this-thats-not-hot
Cold enough, that is to say, to go about a century	http://www.crosswordgiant.com/crossword-clue/1069524/Cold-enough-that-is-to-say-to-go-about-a-century
It's hard to find this among 16 across and 6 down	http://www.crosswordgiant.com/crossword-clue/1070128/Its-hard-to-find-this-among-16-across-and-6-down
It's not that hard, see?	http://www.crosswordgiant.com/crossword-clue/1072378/Its-not-that-hard-see
It's hard to get off to this for work	http://www.crosswordgiant.com/crossword-clue/1073714/Its-hard-to-get-off-to-this-for-work
It's hard, that is to say, about a century	http://www.crosswordgiant.com/crossword-clue/1074253/Its-hard-that-is-to-say-about-a-century
That has the sound of a Sunday	http://www.crosswordgiant.com/crossword-clue/1074981/That-has-the-sound-of-a-Sunday
It's not that that would make one see how hard it is	http://www.crosswordgiant.com/crossword-clue/1076173/Its-not-that-that-would-make-one-see-how-hard-it-is
Off this, there's work to be done there, and it's hard	http://www.crosswordgiant.com/crossword-clue/1078348/Off-this-theres-work-to-be-done-there-and-its-hard
May be a hard bit in the hard stuff	http://www.crosswordgiant.com/crossword-clue/1078543/May-be-a-hard-bit-in-the-hard-stuff
It's not this,you see, that's in the drink	http://www.crosswordgiant.com/crossword-clue/1078945/Its-not-thisyou-see-thats-in-the-drink
It's hard to see how thie could follow 15 across	http://www.crosswordgiant.com/crossword-clue/1079146/Its-hard-to-see-how-thie-could-follow-15-across
Not this for the sound of the sea that's cold	http://www.crosswordgiant.com/crossword-clue/1079712/Not-this-for-the-sound-of-the-sea-thats-cold
Not this, you see, is not so hot	http://www.crosswordgiant.com/crossword-clue/1083847/Not-this-you-see-is-not-so-hot
Or if this might be the whole of it by the sound of it	http://www.crosswordgiant.com/crossword-clue/1086310/Or-if-this-might-be-the-whole-of-it-by-the-sound-of-it
Sort of water that has no 5 down	http://www.crosswordgiant.com/crossword-clue/1087467/Sort-of-water-that-has-no-5-down
How hard it is to get to the end of 1 across (3)	http://www.crosswordgiant.com/crossword-clue/1088701/How-hard-it-is-to-get-to-the-end-of-1-across-3
When it's cold it is hard	http://www.crosswordgiant.com/crossword-clue/1089305/When-its-cold-it-is-hard
Nov. could start this at the start - that's a hard one	http://www.crosswordgiant.com/crossword-clue/1089704/Nov.-could-start-this-at-the-start-thats-a-hard-one
It's not this, you see, that's cold	http://www.crosswordgiant.com/crossword-clue/1092281/Its-not-this-you-see-thats-cold
It's hard that it would not be with this to see	http://www.crosswordgiant.com/crossword-clue/1095537/Its-hard-that-it-would-not-be-with-this-to-see
Off to work there, even when there's a frost	http://www.crosswordgiant.com/crossword-clue/1095939/Off-to-work-there-even-when-theres-a-frost
Or if this could be the whole of it, by the sound of it, if it's hard	http://www.crosswordgiant.com/crossword-clue/1096668/Or-if-this-could-be-the-whole-of-it-by-the-sound-of-it-if-its-hard
See, it's not so hard and not so hot	http://www.crosswordgiant.com/crossword-clue/1099291/See-its-not-so-hard-and-not-so-hot
It's not this hard, you see	http://www.crosswordgiant.com/crossword-clue/1099699/Its-not-this-hard-you-see
Not so soft and not so hot	http://www.crosswordgiant.com/crossword-clue/1101092/Not-so-soft-and-not-so-hot
It's not this that's hard, you see	http://www.crosswordgiant.com/crossword-clue/1102687/Its-not-this-thats-hard-you-see
This is hard, but not this, see?	http://www.crosswordgiant.com/crossword-clue/1104754/This-is-hard-but-not-this-see
See to it that's not this that's frozen	http://www.crosswordgiant.com/crossword-clue/1105544/See-to-it-thats-not-this-thats-frozen
Is not this hard to see?	http://www.crosswordgiant.com/crossword-clue/1106130/Is-not-this-hard-to-see
It's not to see that this is real cool	http://www.crosswordgiant.com/crossword-clue/1107936/Its-not-to-see-that-this-is-real-cool
It's not this that's hard to see	http://www.crosswordgiant.com/crossword-clue/1108134/Its-not-this-thats-hard-to-see
Art, if it gets to this, is just a trick	http://www.crosswordgiant.com/crossword-clue/1108334/Art-if-it-gets-to-this-is-just-a-trick
It's not so hot to be so cold and hard	http://www.crosswordgiant.com/crossword-clue/1111095/Its-not-so-hot-to-be-so-cold-and-hard
How hard that one will always get a cold from it	http://www.crosswordgiant.com/crossword-clue/1111463/How-hard-that-one-will-always-get-a-cold-from-it
It's hard how evil this could be after five	http://www.crosswordgiant.com/crossword-clue/1111853/Its-hard-how-evil-this-could-be-after-five
It's not this, you see	http://www.crosswordgiant.com/crossword-clue/1113267/Its-not-this-you-see
It's not the sound of the C that's so cold	http://www.crosswordgiant.com/crossword-clue/1113664/Its-not-the-sound-of-the-C-thats-so-cold
Not so hot to be so hard in drink	http://www.crosswordgiant.com/crossword-clue/1114260/Not-so-hot-to-be-so-hard-in-drink
It's not this that's hard to regard	http://www.crosswordgiant.com/crossword-clue/1115942/Its-not-this-thats-hard-to-regard
It's never so hot to get just this from the court	http://www.crosswordgiant.com/crossword-clue/1116207/Its-never-so-hot-to-get-just-this-from-the-court
However hard, it's not this, see	http://www.crosswordgiant.com/crossword-clue/1118714/However-hard-its-not-this-see
It's hard to get off with this for work when it's so cold	http://www.crosswordgiant.com/crossword-clue/1120679/Its-hard-to-get-off-with-this-for-work-when-its-so-cold
It's not this, see, that makes the water hard	http://www.crosswordgiant.com/crossword-clue/1123411/Its-not-this-see-that-makes-the-water-hard
Hard to get to the end of 13 across - cold, too (3)	http://www.crosswordgiant.com/crossword-clue/1126319/Hard-to-get-to-the-end-of-13-across-cold-too-3
See that it's not so hard as this	http://www.crosswordgiant.com/crossword-clue/1128073/See-that-its-not-so-hard-as-this
Nice at last to have it 21 down	http://www.crosswordgiant.com/crossword-clue/1130041/Nice-at-last-to-have-it-21-down
Hard to make it with no heat	http://www.crosswordgiant.com/crossword-clue/1130225/Hard-to-make-it-with-no-heat
Sounds as if one frees this, but it's hard	http://www.crosswordgiant.com/crossword-clue/1131028/Sounds-as-if-one-frees-this-but-its-hard
It's not this that's hard, see	http://www.crosswordgiant.com/crossword-clue/1132974/Its-not-this-thats-hard-see
It's not so hot to have it in a drink	http://www.crosswordgiant.com/crossword-clue/1133950/Its-not-so-hot-to-have-it-in-a-drink
It's not this, see, that's not so hot	http://www.crosswordgiant.com/crossword-clue/1134308/Its-not-this-see-thats-not-so-hot
Being off this is not being off work there	http://www.crosswordgiant.com/crossword-clue/1134499/Being-off-this-is-not-being-off-work-there
See it's not this	http://www.crosswordgiant.com/crossword-clue/1134957/See-its-not-this
It's hard, but it's not this, see	http://www.crosswordgiant.com/crossword-clue/1139699/Its-hard-but-its-not-this-see
See, it's not this that's not so hot	http://www.crosswordgiant.com/crossword-clue/1141665/See-its-not-this-thats-not-so-hot
See that it's not this that makes the water hard	http://www.crosswordgiant.com/crossword-clue/1146112/See-that-its-not-this-that-makes-the-water-hard
See that it's not coming out of the deep-freeze	http://www.crosswordgiant.com/crossword-clue/1147088/See-that-its-not-coming-out-of-the-deep-freeze
It's hard to keep things on this	http://www.crosswordgiant.com/crossword-clue/1148259/Its-hard-to-keep-things-on-this
It's not this, you see, that's so cold	http://www.crosswordgiant.com/crossword-clue/1150584/Its-not-this-you-see-thats-so-cold
Not as cold as this, see?	http://www.crosswordgiant.com/crossword-clue/1152923/Not-as-cold-as-this-see
See that it's not this that hasn't melted	http://www.crosswordgiant.com/crossword-clue/1153697/See-that-its-not-this-that-hasnt-melted
It's not this that's hard, see?	http://www.crosswordgiant.com/crossword-clue/1154278/Its-not-this-thats-hard-see
Off this one gets on with the work there	http://www.crosswordgiant.com/crossword-clue/1155778/Off-this-one-gets-on-with-the-work-there
It's hard, but not hard to make 15 across of it (3)	http://www.crosswordgiant.com/crossword-clue/1155936/Its-hard-but-not-hard-to-make-15-across-of-it-3
You'll see that it's not this that's hard to be so cold	http://www.crosswordgiant.com/crossword-clue/1162182/Youll-see-that-its-not-this-thats-hard-to-be-so-cold
Not with this will you see the water is hard	http://www.crosswordgiant.com/crossword-clue/1162569/Not-with-this-will-you-see-the-water-is-hard
Hard as a rock and not so hot	http://www.crosswordgiant.com/crossword-clue/1162962/Hard-as-a-rock-and-not-so-hot
3 down?	http://www.crosswordgiant.com/crossword-clue/1163160/3-down
It would be not like this to see how cold it is	http://www.crosswordgiant.com/crossword-clue/1165314/It-would-be-not-like-this-to-see-how-cold-it-is
By the sound of it, frees the hard way	http://www.crosswordgiant.com/crossword-clue/1165509/By-the-sound-of-it-frees-the-hard-way
You'd see this if it were not so frozen	http://www.crosswordgiant.com/crossword-clue/1167930/Youd-see-this-if-it-were-not-so-frozen
'Not so cold, see? (3)'	http://www.crosswordgiant.com/crossword-clue/1171259/Not-so-cold-see-3
You'll see that it's not this that makes hard water	http://www.crosswordgiant.com/crossword-clue/1172051/Youll-see-that-its-not-this-that-makes-hard-water
Arctic pier material	http://www.crosswordgiant.com/crossword-clue/1193367/Arctic-pier-material
Glacier, essentially	http://www.crosswordgiant.com/crossword-clue/1193859/Glacier-essentially
Bartender's "rocks"	http://www.crosswordgiant.com/crossword-clue/1201936/Bartenders-rocks
Blocks from the refrigerator	http://www.crosswordgiant.com/crossword-clue/1204044/Blocks-from-the-refrigerator
Berg makeup	http://www.crosswordgiant.com/crossword-clue/1205991/Berg-makeup
It clinks in drinks	http://www.crosswordgiant.com/crossword-clue/1207903/It-clinks-in-drinks
Ship navigation hazard	http://www.crosswordgiant.com/crossword-clue/1210240/Ship-navigation-hazard
With 3-Down, Bud product	http://www.crosswordgiant.com/crossword-clue/1212887/With-3-Down-Bud-product
Winter sculpture medium	http://www.crosswordgiant.com/crossword-clue/1215601/Winter-sculpture-medium
Diamonds, as it were	http://www.crosswordgiant.com/crossword-clue/1216493/Diamonds-as-it-were
It's found in rinks and drinks	http://www.crosswordgiant.com/crossword-clue/1218202/Its-found-in-rinks-and-drinks
Nail down or cool down	http://www.crosswordgiant.com/crossword-clue/1222645/Nail-down-or-cool-down
Curling venue	http://www.crosswordgiant.com/crossword-clue/1222815/Curling-venue
Trump ___ (defunct bottled water brand)	http://www.crosswordgiant.com/crossword-clue/1227164/Trump-___-defunct-bottled-water-brand
Winter road hazard	http://www.crosswordgiant.com/crossword-clue/1230561/Winter-road-hazard
34-Across's realm	http://www.crosswordgiant.com/crossword-clue/1236972/34-Acrosss-realm
Hailstones, essentially	http://www.crosswordgiant.com/crossword-clue/1239182/Hailstones-essentially
Water, when it gets cold enough	http://www.crosswordgiant.com/crossword-clue/1241285/Water-when-it-gets-cold-enough
Makeup of some sheets	http://www.crosswordgiant.com/crossword-clue/1242218/Makeup-of-some-sheets
Beverage cooler	http://www.crosswordgiant.com/crossword-clue/1245380/Beverage-cooler
Last-minute party purchase	http://www.crosswordgiant.com/crossword-clue/1251966/Last-minute-party-purchase
Winter glaze	http://www.crosswordgiant.com/crossword-clue/1253349/Winter-glaze
Word repeated before 'Baby' in a hip-hop title	http://www.crosswordgiant.com/crossword-clue/1254970/Word-repeated-before-Baby-in-a-hip-hop-title
There'll be talk if this is broken	http://www.crosswordgiant.com/crossword-clue/1298327/Therell-be-talk-if-this-is-broken
Dropped in for a cold drink	http://www.crosswordgiant.com/crossword-clue/1316674/Dropped-in-for-a-cold-drink
Diamonds, that is, capturing clubs	http://www.crosswordgiant.com/crossword-clue/1340149/Diamonds-that-is-capturing-clubs
Diamonds!	http://www.crosswordgiant.com/crossword-clue/1351908/Diamonds
It's cold	http://www.crosswordgiant.com/crossword-clue/1358528/Its-cold
Frozen liquid	http://www.crosswordgiant.com/crossword-clue/1360021/Frozen-liquid
Frozen water - diamonds	http://www.crosswordgiant.com/crossword-clue/1361379/Frozen-water-diamonds
Chill - harden	http://www.crosswordgiant.com/crossword-clue/1375377/Chill-harden
Cold stuff	http://www.crosswordgiant.com/crossword-clue/1388816/Cold-stuff
Cubes in a drink	http://www.crosswordgiant.com/crossword-clue/1392899/Cubes-in-a-drink
Diamonds (slang)	http://www.crosswordgiant.com/crossword-clue/1397133/Diamonds-slang
Decorate with frosting	http://www.crosswordgiant.com/crossword-clue/1401935/Decorate-with-frosting
Yegg's diamonds	http://www.crosswordgiant.com/crossword-clue/1414462/Yeggs-diamonds
Coco's co-star	http://www.crosswordgiant.com/crossword-clue/1417630/Cocos-co-star
Clinch, in slang	http://www.crosswordgiant.com/crossword-clue/1420848/Clinch-in-slang
Water at 31 degrees	http://www.crosswordgiant.com/crossword-clue/1424504/Water-at-31-degrees
Cover at the bakery	http://www.crosswordgiant.com/crossword-clue/1438712/Cover-at-the-bakery
Scotch dilutant	http://www.crosswordgiant.com/crossword-clue/1441108/Scotch-dilutant
With 100-Down, did an axel or a lutz	http://www.crosswordgiant.com/crossword-clue/1442216/With-100-Down-did-an-axel-or-a-lutz
What makes a drink clink	http://www.crosswordgiant.com/crossword-clue/1451547/What-makes-a-drink-clink
Rink coverer	http://www.crosswordgiant.com/crossword-clue/1451861/Rink-coverer
Type of tray or cube	http://www.crosswordgiant.com/crossword-clue/1452289/Type-of-tray-or-cube
Freezer tray contents	http://www.crosswordgiant.com/crossword-clue/1455907/Freezer-tray-contents
Bobsled run surface	http://www.crosswordgiant.com/crossword-clue/1460897/Bobsled-run-surface
Treat, as a bruise	http://www.crosswordgiant.com/crossword-clue/1467599/Treat-as-a-bruise
With 83-Down, glacial epoch	http://www.crosswordgiant.com/crossword-clue/1468677/With-83-Down-glacial-epoch
It makes a drink clink	http://www.crosswordgiant.com/crossword-clue/1470650/It-makes-a-drink-clink
119 Down surface	http://www.crosswordgiant.com/crossword-clue/1474148/119-Down-surface
Type of tray or chest	http://www.crosswordgiant.com/crossword-clue/1495184/Type-of-tray-or-chest
Swelling reliever	http://www.crosswordgiant.com/crossword-clue/1496259/Swelling-reliever
__ cold	http://www.crosswordgiant.com/crossword-clue/1496568/__-cold
Milieu for axels	http://www.crosswordgiant.com/crossword-clue/1496895/Milieu-for-axels
Put away	http://www.crosswordgiant.com/crossword-clue/14376/Put-away
